ID,TotalStats,BaseStats,Overall,Potential,Growth
158023,2219,462,93,93,0
188545,2212,460,92,92,0
20801,2208,457,91,91,0
231747,2175,470,91,95,4
200389,1413,489,91,93,2
192985,2304,485,91,91,0
190871,2183,454,91,91,0
215914,2179,470,90,90,0
202126,2205,456,90,90,0
192448,1444,484,90,92,2
167495,1534,501,90,90,0
200104,2142,455,89,89,0
200145,2219,462,89,89,0
165153,2116,446,89,89,0
192119,1327,469,89,91,2
208722,2192,465,89,89,0
203376,2104,455,89,89,0
230621,1377,481,89,93,4
209331,2211,468,89,89,0
210257,1583,501,89,91,2
212622,2283,475,89,90,1
212831,1393,486,89,90,1
192505,2064,445,88,88,0
155862,2251,461,88,88,0
176580,2307,457,88,88,0
182521,2148,445,88,88,0
239085,2102,458,88,93,5
193041,1428,477,88,88,0
212198,2341,481,88,89,1
202652,2113,451,88,89,1
199556,2202,449,87,87,0
177003,2253,464,87,87,0
183898,2177,455,87,87,0
186153,1317,465,87,87,0
189596,2136,440,87,87,0
192387,2065,437,87,87,0
195864,2222,472,87,87,0
209658,2314,496,87,88,1
207865,2074,452,87,90,3
211110,2134,447,87,88,1
216267,2163,465,87,88,1
228702,2229,478,87,92,5
231281,2227,467,87,92,5
239818,1886,407,87,91,4
153079,2068,424,87,87,0
167948,1372,472,87,87,0
233049,2007,431,87,91,4
201024,1705,397,86,86,0
232363,1829,413,86,88,2
201535,1931,427,86,88,2
198219,2025,421,86,86,0
192984,1309,464,86,87,1
189513,2167,444,86,86,0
189511,2012,420,86,86,0
189509,2199,447,86,86,0
189332,2215,467,86,86,0
178603,2043,430,86,86,0
138956,1851,406,86,86,0
162835,1289,454,86,86,0
231866,2098,449,86,89,3
226161,2252,491,86,89,3
204485,2035,430,86,86,0
208093,2118,445,86,86,0
208830,2135,444,86,86,0
210514,2227,475,86,87,1
212218,1976,419,86,89,3
213345,1974,426,86,87,1
218667,2128,451,86,86,0
209499,2163,459,86,88,2
201942,2180,460,85,85,0
194765,2259,459,85,85,0
183277,2055,432,85,85,0
185122,1303,456,85,85,0
179813,2093,427,85,85,0
177683,1356,467,85,85,0
168542,2043,416,85,85,0
202556,2081,441,85,86,1
163587,1358,463,85,85,0
143076,2060,430,85,85,0
186942,2198,461,85,85,0
188350,2126,436,85,85,0
184344,1975,428,85,85,0
188377,2194,471,85,85,0
188567,2049,432,85,85,0
193747,2227,470,85,85,0
164240,2022,414,85,85,0
206113,2080,444,85,86,1
198176,1863,412,85,85,0
235243,1975,431,85,90,5
235212,2188,482,85,88,3
231677,2146,458,85,89,4
231478,2145,454,85,89,4
230142,2056,433,85,89,4
226790,2113,442,85,88,3
223848,2224,473,85,87,2
205498,2133,435,85,85,0
204963,2124,453,85,85,0
200458,2227,464,84,84,0
197445,2247,467,84,84,0
198706,2009,423,84,84,0
199434,2109,439,84,84,0
199451,2108,440,84,84,0
237692,2060,442,84,92,8
200647,2056,438,84,84,0
202811,1449,476,84,85,1
192629,2071,430,84,84,0
203263,1950,416,84,86,2
193080,1425,465,84,84,0
152729,1977,420,84,84,0
186345,2183,447,84,84,0
184134,2046,441,84,84,0
183711,2198,460,84,84,0
181291,2271,476,84,84,0
175943,2002,419,84,84,0
204923,2229,468,84,85,1
146536,2175,458,84,84,0
41236,2040,420,84,84,0
235790,2038,434,84,92,8
204639,1730,375,84,84,0
232656,2185,480,84,90,6
216393,2187,451,84,87,3
206517,2022,437,84,85,1
216594,2117,452,84,84,0
222492,2080,441,84,87,3
224232,2236,467,84,89,5
224334,2292,480,84,84,0
216352,2203,459,84,84,0
228941,2062,432,84,85,1
230938,2196,474,84,86,2
205988,2130,453,84,86,2
207862,1961,422,84,85,1
207863,1798,390,84,84,0
208418,2087,445,84,84,0
208574,2227,478,84,84,0
208670,2087,440,84,84,0
209889,2175,459,84,84,0
210243,2186,465,84,84,0
212188,2012,430,84,87,3
215698,1456,469,84,89,5
216460,1795,398,84,88,4
197655,1808,406,83,83,0
203574,1959,428,83,86,3
199914,2130,460,83,83,0
200610,2126,445,83,83,0
201153,1945,423,83,83,0
201399,1927,399,83,83,0
202884,2110,459,83,83,0
203841,1275,454,83,83,0
204838,2091,440,83,83,0
199845,1879,407,83,83,0
192774,1652,377,83,83,0
205452,1900,417,83,84,1
183907,1943,424,83,83,0
135507,2138,442,83,83,0
169416,2006,422,83,83,0
177413,2165,453,83,83,0
178750,1368,466,83,83,0
179645,1903,407,83,83,0
180930,1962,420,83,83,0
184087,1991,412,83,83,0
192883,2146,458,83,83,0
184432,2068,429,83,83,0
189575,2073,438,83,83,0
190286,2205,468,83,83,0
190941,1197,443,83,83,0
191043,2148,459,83,83,0
192563,1357,465,83,84,1
204935,1495,462,83,85,2
241486,1914,424,83,89,6
205632,2215,473,83,83,0
225850,1951,429,83,87,4
197061,1870,403,83,83,0
207410,2125,449,83,84,1
242444,2065,431,83,91,8
239053,2175,474,83,89,6
235805,2052,453,83,91,8
234642,1168,442,83,85,2
233064,2099,440,83,89,6
231443,1990,426,83,88,5
230666,2062,436,83,87,4
230658,2154,449,83,85,2
230481,2098,439,83,83,0
229880,2005,441,83,87,4
228618,2148,474,83,86,3
193082,2229,478,83,83,0
225193,2244,478,83,87,4
215333,1901,419,83,83,0
223697,2192,468,83,83,0
213565,2155,449,83,86,3
213648,2091,446,83,86,3
214997,2127,457,83,86,3
209989,2162,467,83,83,0
216354,2057,420,83,83,0
220651,2209,461,83,86,3
220814,2007,432,83,86,3
220834,2032,431,83,86,3
223689,1919,412,83,83,0
211688,2097,453,83,86,3
234396,2115,467,82,89,7
230869,1283,451,82,86,4
231943,2124,451,82,87,5
232488,1841,401,82,87,5
233096,2016,446,82,84,2
233419,2098,449,82,87,5
233731,1910,411,82,86,4
241461,1995,422,82,90,8
234943,2021,431,82,87,5
235410,1891,409,82,86,4
235569,2118,453,82,87,5
236792,2110,451,82,85,3
240130,2018,438,82,89,7
230168,1201,443,82,82,0
241464,1883,410,82,89,7
241671,1335,453,82,87,5
244260,2037,420,82,87,5
230375,1885,405,82,82,0
227796,1955,415,82,88,6
229984,2058,437,82,86,4
220697,2087,435,82,85,3
212190,1675,379,82,87,5
212462,2235,466,82,82,0
212523,2168,454,82,83,1
212616,2179,466,82,83,1
216547,1997,429,82,82,0
219693,1930,418,82,84,2
220018,2101,454,82,82,0
120533,1893,420,82,82,0
222077,2113,447,82,87,5
229906,2011,426,82,86,4
222665,2090,438,82,88,6
224293,2168,443,82,87,5
224458,2148,457,82,87,5
225100,1809,407,82,88,6
226271,2115,447,82,86,4
229391,2033,440,82,87,5
229558,1846,416,82,90,8
229668,2007,430,82,85,3
220440,1895,410,82,86,4
190460,2009,414,82,82,0
157481,1733,364,82,82,0
205070,2177,462,82,82,0
199110,2005,426,82,82,0
199482,1376,462,82,83,1
199823,2134,450,82,82,0
201305,1976,421,82,82,0
201519,2198,465,82,83,1
202651,1947,407,82,82,0
203486,2088,440,82,82,0
205069,2124,452,82,82,0
208128,2084,430,82,83,1
197781,2060,428,82,82,0
208333,2270,485,82,83,1
208421,2199,463,82,85,3
208461,2118,442,82,82,0
209981,1251,437,82,82,0
210035,2184,461,82,85,3
210413,1765,394,82,83,1
210935,2029,430,82,82,0
211256,2081,445,82,82,0
198717,1970,436,82,82,0
194404,1333,454,82,82,0
164835,1261,448,82,82,0
188152,2149,447,82,82,0
168435,1243,445,82,82,0
168651,2131,443,82,82,0
173731,2177,453,82,82,0
178005,1368,457,82,82,0
178562,2159,450,82,82,0
180206,2147,439,82,82,0
183512,2178,464,82,82,0
187072,2147,440,82,82,0
188943,1240,454,82,82,0
193698,1261,450,82,82,0
189242,2086,428,82,82,0
190815,2097,425,82,82,0
192318,2082,434,82,82,0
193105,1378,460,82,84,2
193165,2167,448,82,82,0
193301,2048,429,82,82,0
193474,2103,445,82,82,0
193525,2095,452,82,82,0
211515,1264,451,82,87,5
234378,1976,425,82,87,5
200888,2027,437,81,81,0
235374,2032,448,81,81,0
209297,2169,447,81,81,0
208618,2136,452,81,81,0
208596,1959,415,81,82,1
208448,1934,405,81,81,0
251854,2023,435,81,91,10
251573,2161,460,81,86,5
247394,2089,451,81,89,8
247263,1914,421,81,88,7
245279,2039,445,81,84,3
241852,1884,414,81,88,7
240950,2094,441,81,88,7
239231,2107,451,81,87,6
238074,2098,449,81,86,5
208330,1908,405,81,81,0
210385,1214,430,81,84,3
207439,2175,454,81,83,2
206511,2161,453,81,82,1
205678,2070,435,81,81,0
205659,1224,438,81,83,2
205569,2139,437,81,84,3
205175,1955,401,81,82,1
204638,1673,355,81,82,1
204525,1979,416,81,81,0
204311,1905,401,81,84,3
204120,1315,437,81,81,0
203551,2178,450,81,81,0
202695,1869,396,81,82,1
201095,1368,451,81,81,0
210008,2136,460,81,82,1
210406,2115,453,81,82,1
230225,2003,413,81,81,0
221992,2013,427,81,82,1
230258,2033,434,81,81,0
230294,1904,400,81,81,0
230347,2068,436,81,81,0
228251,2190,462,81,86,5
227950,1906,401,81,83,2
227127,1287,447,81,84,3
226226,2174,458,81,85,4
226166,1995,433,81,85,4
226110,2005,426,81,82,1
225375,2136,461,81,85,4
224411,1998,427,81,86,5
224081,2090,443,81,85,4
223952,1273,436,81,82,1
221479,1963,422,81,85,4
210411,2088,442,81,82,1
221363,2141,450,81,86,5
220407,1329,444,81,81,0
220093,2057,453,81,81,0
217940,1836,391,81,82,1
216475,2118,448,81,81,0
216409,1994,419,81,81,0
216201,2039,440,81,82,1
215330,1972,429,81,82,1
214979,1222,445,81,83,2
212194,2016,426,81,85,4
211990,1258,434,81,83,2
211300,2003,429,81,84,3
210463,2028,434,81,81,0
200949,2088,436,81,81,0
230256,2133,459,81,81,0
200724,1878,411,81,81,0
234906,2115,446,81,86,5
163705,1275,448,81,81,0
167664,1871,391,81,81,0
171791,1738,362,81,81,0
172871,2054,437,81,81,0
176266,2028,420,81,81,0
178086,1322,455,81,81,0
181458,2154,453,81,81,0
181872,2224,466,81,81,0
183574,2009,414,81,81,0
184200,2113,443,81,81,0
187754,2043,434,81,81,0
190674,2119,445,81,81,0
192366,1894,404,81,81,0
234742,1970,428,81,84,3
200454,1976,406,81,81,0
234153,2169,460,81,88,7
233927,2196,464,81,85,4
232411,2127,453,81,86,5
231969,2195,461,81,81,0
230430,1874,399,81,81,0
193283,2197,459,81,81,0
193314,1331,446,81,81,0
193983,2055,436,81,81,0
195365,2063,428,81,81,0
195859,2055,427,81,81,0
197965,2146,445,81,81,0
198164,2133,451,81,81,0
198710,2091,421,81,81,0
163489,1206,438,81,81,0
156519,2157,459,81,81,0
153244,2017,424,81,81,0
124375,1978,416,81,81,0
45186,1960,412,81,81,0
200260,2033,427,81,81,0
199987,1325,452,81,81,0
199564,2071,445,81,81,0
199304,2128,448,81,81,0
139068,1981,418,81,81,0
213661,1732,384,80,85,5
209519,2032,431,80,81,1
209960,1300,434,80,82,2
210455,1987,423,80,81,1
211117,2115,446,80,82,2
212151,1215,438,80,83,3
212187,2113,451,80,81,1
212814,2058,435,80,80,0
215223,1281,442,80,82,2
214584,1294,428,80,80,0
215316,1308,450,80,80,0
217870,2112,454,80,80,0
219683,2166,452,80,81,1
219953,2103,444,80,80,0
220182,1902,425,80,83,3
220971,2064,435,80,83,3
221087,1342,442,80,80,0
221660,1967,417,80,82,2
222331,1900,430,80,84,4
222716,1946,414,80,83,3
223724,2019,440,80,80,0
198141,2043,433,80,80,0
201143,1967,410,80,81,1
208808,2079,440,80,80,0
171877,2139,448,80,80,0
231447,1986,428,80,85,5
1179,1270,418,80,80,0
140233,1255,438,80,80,0
148119,1243,443,80,80,0
162347,2126,421,80,80,0
169588,1729,363,80,80,0
171579,2165,430,80,80,0
172522,2189,461,80,80,0
183855,1733,375,80,80,0
173426,1287,448,80,80,0
176676,2157,459,80,80,0
177388,1992,416,80,80,0
177509,1735,385,80,80,0
177604,2010,422,80,80,0
178518,2197,460,80,80,0
182493,1838,386,80,80,0
232119,1840,409,80,83,3
232293,1961,426,80,87,7
233195,2060,443,80,84,4
233306,1250,445,80,87,7
246669,2045,439,80,88,8
244470,2079,440,80,80,0
244369,1954,418,80,86,6
243576,2069,449,80,87,7
241095,2046,440,80,86,6
241084,1938,424,80,86,6
240900,1561,348,80,84,4
240709,2095,459,80,85,5
239207,1911,402,80,85,5
238794,1919,418,80,90,10
237383,1801,393,80,89,9
237238,2103,453,80,84,4
236987,1954,425,80,86,6
236583,1065,409,80,82,2
236401,2023,444,80,85,5
182494,1389,452,80,80,0
184941,2066,427,80,80,0
207877,1915,399,80,80,0
204399,2050,424,80,80,0
201922,2059,429,80,80,0
202024,2066,442,80,80,0
202166,2075,436,80,80,0
202325,1988,403,80,80,0
203890,2050,436,80,80,0
203895,2019,419,80,80,0
203980,2049,425,80,80,0
204970,2046,427,80,80,0
185020,1984,417,80,80,0
205600,2020,420,80,80,0
205686,2134,444,80,80,0
205693,1934,413,80,81,1
205705,1813,393,80,80,0
205849,1281,446,80,81,1
207599,1834,396,80,81,1
207732,1965,414,80,80,0
201400,2124,446,80,80,0
223959,2098,448,80,84,4
201119,2063,451,80,80,0
199254,2031,423,80,80,0
186561,2082,432,80,80,0
187598,1891,395,80,80,0
189117,1248,430,80,80,0
189271,2094,448,80,80,0
189690,1370,448,80,80,0
190972,2096,443,80,80,0
193061,2116,452,80,80,0
196432,2114,443,80,80,0
197225,2068,433,80,80,0
197242,2081,443,80,80,0
198009,1268,448,80,82,2
198031,2140,438,80,80,0
198950,2024,427,80,80,0
198951,2003,430,80,80,0
199042,2139,441,80,80,0
223816,2014,431,80,80,0
216189,2153,461,80,80,0
224179,1872,398,80,80,0
230201,1954,422,80,80,0
227290,1299,432,80,81,1
227813,2146,444,80,85,5
227928,2016,438,80,81,1
229237,1939,428,80,83,3
229261,2034,458,80,86,6
229582,1727,379,80,84,4
229857,2039,419,80,83,3
229927,2132,452,80,84,4
224309,2062,439,80,81,1
230271,1834,383,80,80,0
230313,1788,383,80,80,0
230767,2218,475,80,86,6
226754,2160,450,80,84,4
226491,2083,450,80,86,6
225953,2016,429,80,84,4
225201,2113,445,80,81,1
225085,2012,425,80,83,3
230204,1264,435,80,80,0
230498,1907,400,79,79,0
192123,1905,394,79,79,0
191202,1964,403,79,79,0
191740,2138,446,79,79,0
192064,2032,430,79,79,0
192906,2071,422,79,79,0
192598,2104,443,79,79,0
192638,2131,439,79,79,0
192789,2048,440,79,79,0
190745,1237,444,79,79,0
190813,1988,425,79,79,0
189615,2057,425,79,79,0
190717,2115,448,79,79,0
190584,2031,419,79,79,0
189805,1910,389,79,79,0
189682,1793,383,79,79,0
193348,2040,425,79,79,0
189560,1974,403,79,79,0
188042,2087,435,79,79,0
188041,2060,436,79,79,0
187052,2045,430,79,79,0
186682,1939,401,79,79,0
193198,2092,436,79,79,0
198230,1645,363,79,79,0
194209,1970,409,79,79,0
202048,1937,400,79,81,2
204024,1849,389,79,79,0
203483,2124,450,79,79,0
203299,1963,425,79,79,0
202935,1774,375,79,79,0
202857,1946,420,79,79,0
202750,1764,388,79,79,0
202648,2094,440,79,80,1
202477,1917,411,79,79,0
202335,1966,412,79,80,1
201455,2137,460,79,79,0
194333,1155,405,79,79,0
200726,1155,434,79,80,1
200315,1997,428,79,79,0
199503,1962,411,79,79,0
199354,1979,414,79,79,0
198946,2033,423,79,79,0
198784,2122,456,79,79,0
198329,2051,434,79,79,0
178509,1892,382,79,79,0
196978,1949,420,79,79,0
184484,2055,416,79,79,0
170890,2089,442,79,79,0
176919,1403,438,79,79,0
226300,1318,442,79,83,4
223597,1998,428,79,79,0
224031,2065,446,79,79,0
224196,2039,436,79,82,3
224490,1995,434,79,82,3
225116,1214,429,79,86,7
225508,1834,396,79,80,1
225663,2139,452,79,83,4
226162,2064,439,79,84,5
226221,1750,375,79,81,2
226456,2062,438,79,82,3
223249,1303,429,79,79,0
226851,2000,419,79,82,3
228093,1980,435,79,85,6
228520,2007,432,79,80,1
228687,1883,398,79,83,4
230184,2016,427,79,79,0
230216,1930,423,79,79,0
230234,2040,433,79,79,0
230251,2099,446,79,79,0
230312,1191,446,79,79,0
223578,1826,392,79,79,0
222501,1948,427,79,82,3
176635,1797,366,79,79,0
216150,2044,435,79,79,0
176550,1195,426,79,79,0
173221,2056,432,79,79,0
162240,2121,449,79,79,0
159145,1878,391,79,79,0
158121,1190,439,79,79,0
156616,1880,391,79,79,0
213516,2018,423,79,80,1
204234,1250,432,79,80,1
216145,1699,376,79,80,1
216388,1855,404,79,84,5
222028,2009,426,79,82,3
216531,1942,408,79,79,0
218339,2072,436,79,82,3
219789,2019,437,79,79,0
219809,1904,415,79,81,2
220253,1970,415,79,80,1
220523,1746,380,79,81,2
220673,2095,445,79,83,4
220793,1769,400,79,81,2
221491,1818,401,79,83,4
214047,2138,456,79,79,0
204538,1948,407,79,79,0
204259,2005,427,79,79,0
210513,1954,403,79,79,0
251809,1736,379,79,85,6
252371,2077,449,79,89,10
255475,1950,421,79,88,9
212442,1227,423,79,81,2
212404,2091,439,79,79,0
212382,1841,409,79,80,1
212096,1968,407,79,79,0
211748,2103,430,79,79,0
211241,2073,443,79,79,0
211022,1999,418,79,79,0
210897,1830,404,79,82,3
210625,1979,435,79,82,3
210324,2021,428,79,79,0
247204,2039,443,79,84,5
210315,1972,411,79,82,3
209846,1977,433,79,79,0
208165,1707,375,79,79,0
208135,2087,452,79,79,0
208104,1242,436,79,81,2
207566,1913,404,79,79,0
207494,2093,437,79,79,0
206585,1299,430,79,83,4
206545,2049,420,79,79,0
206467,2049,422,79,79,0
205923,1987,428,79,79,0
138412,2141,436,79,79,0
247851,2057,435,79,84,5
41,1955,403,79,79,0
244067,1742,398,79,86,7
236480,2105,444,79,84,5
243812,1928,405,79,88,9
232432,1912,404,79,84,5
232580,1713,381,79,84,5
232665,1934,405,79,84,5
232730,1924,405,79,82,3
232756,1782,399,79,85,6
233738,2082,443,79,84,5
234035,1975,423,79,82,3
234236,1912,402,79,82,3
234612,1906,411,79,83,4
235073,1158,418,79,84,5
235688,1764,395,79,84,5
206413,2006,425,79,79,0
236506,1773,392,79,85,6
239433,2030,425,79,84,5
236572,2016,437,79,84,5
241788,1926,414,79,79,0
241637,2093,452,79,85,6
240679,2141,441,79,84,5
240243,1983,421,79,86,7
242516,1989,429,79,85,6
239301,2066,436,79,85,6
237239,2123,435,79,80,1
236632,1916,416,79,83,4
237942,1880,406,79,85,6
236610,1875,411,79,87,8
199576,1812,372,78,78,0
24630,1317,436,78,78,0
178007,2052,412,78,78,0
178088,1874,366,78,78,0
203605,1975,414,78,78,0
199189,1996,426,78,79,1
199206,1808,390,78,78,0
198658,2057,442,78,78,0
198657,2070,440,78,78,0
197837,1664,370,78,78,0
146439,1895,389,78,78,0
195096,2065,437,78,78,0
199915,1771,379,78,79,1
152908,2094,430,78,78,0
156433,1339,440,78,78,0
159261,1896,390,78,78,0
163155,1260,429,78,78,0
199715,1965,418,78,78,0
200155,1978,411,78,78,0
200159,1387,442,78,80,2
201042,2053,438,78,78,0
201417,2019,431,78,78,0
201995,1984,431,78,78,0
202493,2049,445,78,78,0
194222,1683,359,78,78,0
195093,1910,404,78,78,0
189053,1877,398,78,78,0
193469,1782,373,78,78,0
187936,1872,394,78,78,0
178213,2022,419,78,78,0
178224,1861,379,78,78,0
178415,2129,436,78,78,0
180216,2032,428,78,78,0
183394,2058,445,78,78,0
184392,1956,417,78,78,0
185103,2172,443,78,78,0
186197,1997,413,78,78,0
199652,2016,425,78,78,0
186801,1947,422,78,78,0
187607,1855,398,78,78,0
188335,1702,377,78,78,0
193408,1991,420,78,78,0
189125,2137,439,78,78,0
189280,2071,422,78,78,0
189505,1931,400,78,78,0
189606,1905,399,78,78,0
189881,1785,386,78,78,0
190243,1228,434,78,78,0
191180,1914,398,78,78,0
192678,1849,398,78,78,0
192679,2049,426,78,78,0
193171,2004,423,78,78,0
193361,2092,440,78,78,0
202849,1710,351,78,79,1
243559,1891,404,78,84,6
203747,1946,418,78,81,3
203843,2103,442,78,78,0
242187,1917,405,78,84,6
241727,1038,410,78,83,5
240753,2013,427,78,85,7
240699,2182,453,78,84,6
239817,1987,429,78,85,7
239613,1988,431,78,84,6
239380,2004,428,78,85,7
238616,1842,402,78,85,7
238476,1632,364,78,84,6
238463,2056,436,78,83,5
238067,2057,451,78,87,9
237678,1705,384,78,86,8
236791,2029,432,78,81,3
236355,1727,384,78,85,7
236045,1940,423,78,79,1
242201,2086,441,78,82,4
243238,1792,390,78,78,0
228413,1187,436,78,81,3
246147,1951,422,78,89,11
244193,1984,422,78,86,8
244253,2094,449,78,85,7
244467,1194,448,78,82,4
244622,1967,425,78,85,7
245630,2034,441,78,83,5
246104,2074,449,78,90,12
246430,1779,389,78,85,7
256630,1935,411,78,89,11
246646,1970,425,78,86,8
246844,1866,410,78,83,5
248243,2089,445,78,89,11
248695,1770,387,78,86,8
252145,2009,430,78,88,10
253163,1706,377,78,86,8
235353,1833,406,78,86,8
234835,1645,360,78,82,4
234060,2034,438,78,84,6
206651,2092,437,78,78,0
230206,1962,431,78,78,0
230183,2101,439,78,78,0
229909,1238,432,78,79,1
208295,1925,408,78,78,0
208268,2015,430,78,82,4
243630,1862,405,78,86,8
206590,1959,413,78,78,0
230285,1676,369,78,78,0
206534,1923,410,78,78,0
205966,1883,399,78,78,0
205409,1294,427,78,78,0
205192,2009,423,78,79,1
204614,2025,416,78,78,0
204082,1697,376,78,79,1
230212,1814,382,78,78,0
230360,2078,444,78,78,0
233486,1585,353,78,83,5
231352,1766,383,78,86,8
232487,1959,423,78,79,1
232229,1231,445,78,86,8
232080,1915,415,78,84,6
231887,2004,421,78,82,4
231691,1232,427,78,83,5
231410,1818,386,78,86,8
231340,2020,437,78,84,6
230385,1824,387,78,78,0
230460,1883,403,78,78,0
230442,1831,392,78,78,0
167397,1927,388,78,78,0
230440,1939,405,78,78,0
230426,1914,409,78,78,0
230406,1896,416,78,78,0
165229,1780,378,78,78,0
228881,1963,414,78,81,3
170368,2073,429,78,78,0
214097,2126,439,78,79,1
219733,1759,375,78,79,1
219581,1794,385,78,81,3
217546,2015,426,78,78,0
217036,2029,432,78,78,0
216643,2028,429,78,79,1
216320,2041,448,78,80,2
216194,1980,410,78,78,0
215590,2056,428,78,78,0
215353,1821,378,78,78,0
214766,1744,373,78,78,0
214092,1882,394,78,80,2
219985,2037,437,78,78,0
214040,2021,444,78,78,0
213956,1914,435,78,81,3
213951,1134,429,78,79,1
213577,1970,422,78,78,0
213331,1615,365,78,82,4
212419,1849,408,78,80,2
212213,2067,433,78,78,0
212207,2116,434,78,78,0
211591,1891,403,78,82,4
210930,1906,398,78,78,0
219792,1953,417,78,80,2
220883,2056,428,78,81,3
210736,2017,430,78,79,1
225341,1735,370,78,81,3
227890,2004,421,78,79,1
227678,1837,403,78,84,6
227535,2099,445,78,83,5
227174,1971,423,78,83,5
227055,2003,429,78,79,1
226789,2038,440,78,82,4
226766,1861,394,78,81,3
225719,1934,411,78,82,4
225711,1903,415,78,82,4
225659,1862,398,78,79,1
225263,1740,380,78,83,5
221697,1961,421,78,83,5
224371,1948,412,78,83,5
224254,2051,441,78,81,3
224069,1900,405,78,78,0
224003,1239,431,78,80,2
223273,2058,434,78,80,2
223053,1904,403,78,78,0
222943,1973,423,78,78,0
222558,2120,456,78,79,1
222493,1713,371,78,80,2
221832,2092,442,78,79,1
210881,2106,448,78,81,3
228336,1934,421,78,81,3
177633,1854,391,78,78,0
208334,2018,419,78,78,0
171897,2112,433,78,78,0
175379,1946,399,78,78,0
175254,1973,421,78,78,0
173909,2118,444,78,78,0
173306,2058,436,78,78,0
172962,2081,439,78,78,0
174543,1480,451,78,78,0
208364,2067,442,78,78,0
208920,1992,424,78,81,3
209973,1813,391,78,78,0
210372,1863,384,78,78,0
210537,2050,421,78,78,0
210665,2075,429,78,78,0
176772,1228,428,78,78,0
234730,1966,426,77,82,5
235844,1927,416,77,83,6
235794,1936,415,77,83,6
235173,2020,432,77,84,7
234833,1175,419,77,82,5
234777,1321,433,77,82,5
234772,1866,402,77,77,0
234468,1961,412,77,81,4
234678,1945,429,77,82,5
234568,2104,450,77,83,6
227275,1290,420,77,82,5
234426,1749,378,77,81,4
236403,1878,418,77,84,7
227476,1916,413,77,77,0
235889,1891,399,77,79,2
236499,1997,427,77,84,7
236441,2034,453,77,80,3
236477,2110,451,77,83,6
227508,2083,434,77,78,1
227528,2010,434,77,77,0
227536,1904,418,77,77,0
227927,1819,398,77,82,5
228295,1711,370,77,81,4
228302,2065,445,77,82,5
228414,1968,411,77,81,4
229167,1991,425,77,82,5
212623,1992,419,77,81,4
212602,1788,392,77,79,2
238041,1932,422,77,82,5
237520,2112,455,77,82,5
236786,1919,412,77,81,4
236772,1961,413,77,87,10
236639,1962,413,77,80,3
236593,1829,391,77,84,7
236532,1732,382,77,84,7
225997,1963,421,77,77,0
236496,2052,435,77,84,7
226637,1794,380,77,82,5
225014,1988,430,77,81,4
225793,1849,411,77,85,8
188988,1861,375,77,77,0
183353,1905,412,77,77,0
183899,1979,411,77,77,0
184703,2058,420,77,77,0
184858,1886,401,77,77,0
185221,1923,401,77,77,0
185239,1786,389,77,77,0
188044,1968,414,77,77,0
188081,1989,422,77,77,0
188103,2039,428,77,77,0
189068,1752,371,77,77,0
181098,1885,383,77,77,0
189250,1891,395,77,77,0
189472,1713,359,77,77,0
190143,1985,414,77,77,0
190149,2056,444,77,77,0
190432,1933,414,77,77,0
190577,1954,407,77,77,0
190875,2135,443,77,77,0
192045,2030,444,77,77,0
192342,1919,402,77,77,0
181820,1912,394,77,77,0
180808,1981,416,77,77,0
193254,2006,432,77,77,0
172114,1986,396,77,77,0
20775,1894,389,77,77,0
49000,1305,416,77,77,0
146748,1203,418,77,77,0
146758,1923,390,77,77,0
152916,2000,413,77,77,0
154472,1753,363,77,77,0
158963,1989,398,77,77,0
165109,1943,413,77,77,0
170597,1245,418,77,77,0
172879,1753,386,77,77,0
180714,1218,420,77,77,0
173432,1837,382,77,77,0
173521,1754,372,77,77,0
173608,1803,374,77,77,0
176600,1990,417,77,77,0
177326,1875,379,77,77,0
178250,1987,401,77,77,0
179605,2031,437,77,77,0
179789,1702,356,77,77,0
180334,1732,362,77,77,0
192816,1802,381,77,77,0
193290,1969,416,77,77,0
225309,1993,419,77,81,4
222709,2056,439,77,77,0
220287,1756,372,77,78,1
220421,2010,441,77,78,1
220502,1995,432,77,80,3
220621,1880,396,77,80,3
221174,2089,438,77,77,0
222357,1982,436,77,82,5
222390,2087,440,77,81,4
222400,1970,412,77,80,3
222509,2013,420,77,80,3
223550,1348,429,77,81,4
220085,1879,391,77,82,5
223874,2083,437,77,80,3
223898,1153,413,77,82,5
224221,1770,381,77,80,3
224389,1968,416,77,84,7
224422,1925,412,77,83,6
224574,2031,438,77,80,3
233531,1893,403,77,83,6
225024,1885,408,77,80,3
225126,2023,420,77,79,2
220132,1810,386,77,77,0
219522,1204,421,77,80,3
193601,1647,358,77,77,0
215071,2122,449,77,77,0
213013,2050,445,77,77,0
213160,2049,438,77,79,2
213655,1818,400,77,79,2
213761,1874,401,77,77,0
213874,2075,439,77,77,0
214009,1931,413,77,78,1
214947,2000,430,77,77,0
214977,1897,411,77,78,1
215057,1942,405,77,77,0
215160,2079,445,77,78,1
219391,2013,426,77,78,1
215441,1911,403,77,81,4
215502,1227,423,77,81,4
216258,1893,411,77,77,0
216435,1969,414,77,80,3
216497,1928,411,77,78,1
217196,1622,351,77,77,0
217877,1902,399,77,79,2
218659,1906,405,77,80,3
219145,1564,336,77,79,2
234128,1887,402,77,80,3
235945,1903,400,77,82,5
233500,1991,428,77,84,7
202851,1866,395,77,77,0
202562,2065,449,77,77,0
202371,2077,444,77,77,0
202282,2079,438,77,77,0
201505,1881,400,77,77,0
201454,2051,431,77,77,0
201377,1827,390,77,78,1
201325,1238,425,77,77,0
201315,1795,376,77,77,0
200536,1973,431,77,77,0
200215,1993,421,77,77,0
200094,2045,443,77,78,1
199641,1230,414,77,79,2
199580,1821,405,77,78,1
199069,1940,415,77,77,0
199005,1354,441,77,79,2
198140,1991,420,77,77,0
198129,1901,407,77,77,0
198118,1931,413,77,77,0
197948,1810,382,77,77,0
197083,2126,440,77,77,0
196147,2115,438,77,77,0
202789,1153,411,77,79,2
203177,1965,434,77,77,0
212153,1940,412,77,77,0
203487,1620,355,77,80,3
211784,1934,407,77,82,5
211575,1994,416,77,77,0
211454,1955,410,77,77,0
211320,1676,367,77,79,2
211147,2045,435,77,80,3
210864,1872,412,77,78,1
210617,1912,402,77,77,0
209440,1929,406,77,77,0
209288,2039,421,77,77,0
208777,1960,407,77,80,3
208004,1849,402,77,77,0
207948,1967,417,77,78,1
207791,1975,430,77,78,1
207664,1817,379,77,77,0
232999,1937,421,77,83,6
206652,1217,429,77,79,2
206493,1648,348,77,77,0
206075,1243,419,77,80,3
204876,2002,435,77,77,0
204341,1752,366,77,77,0
203757,1888,402,77,77,0
195479,2147,453,77,77,0
195272,2105,439,77,77,0
194958,2077,432,77,77,0
194932,1963,411,77,77,0
243388,1890,412,77,82,5
243647,1030,402,77,84,7
244263,1737,384,77,80,3
244621,1842,406,77,80,3
244892,1947,408,77,84,7
245037,1795,390,77,86,9
245155,2026,447,77,86,9
245158,1946,422,77,86,9
245541,1919,411,77,87,10
246172,1867,408,77,85,8
246186,1843,395,77,85,8
246242,1774,387,77,83,6
246420,1812,401,77,88,11
247030,2151,452,77,78,1
247257,1667,370,77,85,8
251116,2102,449,77,78,1
251412,1861,394,77,81,4
252308,1831,405,77,81,4
253109,1987,427,77,83,6
253727,2161,461,77,82,5
254796,1897,411,77,88,11
243282,1978,417,77,83,6
243015,1942,424,77,82,5
242656,1192,418,77,85,8
239901,1792,387,77,82,5
194806,1736,368,77,77,0
194229,1820,388,77,77,0
194022,2013,432,77,77,0
238160,1704,377,77,83,6
238744,2157,461,77,82,5
238857,1971,429,77,78,1
238896,1725,376,77,82,5
239093,2012,436,77,77,0
239482,1879,407,77,84,7
240471,2075,438,77,80,3
241771,1959,429,77,77,0
240690,1903,410,77,83,6
240702,1932,416,77,80,3
240740,1886,403,77,87,10
241049,1876,406,77,82,5
241096,2082,445,77,86,9
241184,1976,434,77,80,3
241202,1848,401,77,84,7
241508,1945,419,77,87,10
241721,1838,406,77,82,5
212067,1286,415,77,77,0
207421,1933,403,77,78,1
212245,2019,434,77,78,1
230331,2047,437,77,77,0
232440,1964,411,77,81,4
232144,1684,371,77,82,5
212501,2093,441,77,80,3
232104,1926,422,77,82,5
231633,1677,365,77,83,6
231628,1919,407,77,84,7
231554,1901,417,77,83,6
231521,2019,422,77,83,6
231318,2092,441,77,83,6
231102,2030,426,77,83,6
230977,1986,428,77,78,1
230965,2080,452,77,82,5
230899,1848,399,77,83,6
230717,1941,415,77,80,3
230431,2004,430,77,77,0
230402,1761,398,77,77,0
230384,2005,436,77,77,0
230379,1667,368,77,77,0
230371,1947,415,77,77,0
212491,2004,435,77,78,1
230349,1920,416,77,77,0
230346,1784,392,77,77,0
230337,2087,432,77,77,0
232862,1898,394,77,77,0
230269,1911,392,77,77,0
232905,2033,438,77,77,0
229773,1924,418,77,79,2
229752,2079,450,77,80,3
229942,1566,349,77,82,5
229971,1970,424,77,80,3
230043,2045,443,77,80,3
230182,1259,413,77,77,0
230197,1920,412,77,77,0
230241,2026,424,77,77,0
207554,1958,424,76,76,0
205391,1976,425,76,77,1
205407,2052,425,76,76,0
205566,2015,431,76,76,0
206003,1282,421,76,79,3
206058,1891,402,76,76,0
206306,2004,415,76,76,0
206115,1869,404,76,79,3
206225,2006,422,76,76,0
206304,2028,411,76,76,0
204308,1276,418,76,78,2
206516,1967,413,76,78,2
205346,1919,420,76,76,0
204529,1843,390,76,76,0
205201,2057,436,76,79,3
202429,1963,422,76,76,0
204277,2028,431,76,76,0
204125,2035,431,76,76,0
204105,2033,432,76,76,0
204077,1835,400,76,79,3
203741,1945,425,76,76,0
203030,1602,332,76,76,0
204691,1996,414,76,76,0
202599,2020,422,76,76,0
202201,1911,411,76,76,0
205186,1449,451,76,76,0
201982,2077,437,76,76,0
201976,1242,415,76,78,2
201956,1761,382,76,76,0
201858,1943,401,76,76,0
246708,1976,424,76,76,0
246785,1715,359,76,86,10
204760,1957,417,76,76,0
205083,2027,423,76,76,0
202685,1969,418,76,76,0
212228,1966,414,76,80,4
212127,1970,419,76,76,0
212204,1636,358,76,77,1
216549,1888,409,76,79,3
216700,1975,426,76,76,0
216939,1191,418,76,76,0
217699,1906,392,76,76,0
219244,1297,430,76,80,4
219681,2038,433,76,77,1
220196,1937,410,76,82,6
220477,1585,350,76,76,0
220570,1563,337,76,82,6
220659,2032,432,76,79,3
220746,1966,419,76,78,2
220831,1982,435,76,81,5
221714,1961,420,76,81,5
221841,1970,415,76,82,6
222368,1826,390,76,79,3
222404,2009,435,76,82,6
222461,1788,392,76,77,1
222515,1852,395,76,76,0
222715,1917,406,76,78,2
223113,1791,383,76,79,3
223154,2083,452,76,79,3
223329,1925,413,76,77,1
223627,1942,407,76,76,0
223690,1197,422,76,78,2
224116,1816,380,76,76,0
224151,1933,412,76,76,0
224158,2040,435,76,79,3
216433,1890,401,76,77,1
216350,1931,423,76,76,0
216065,1263,415,76,76,0
213135,1845,397,76,79,3
212219,1858,403,76,79,3
212232,1957,407,76,76,0
212242,2085,434,76,77,1
212260,1919,408,76,76,0
212269,2093,445,76,80,4
212300,1732,380,76,79,3
212678,2010,419,76,77,1
212692,1850,391,76,78,2
212715,1960,422,76,76,0
212811,2067,436,76,76,0
212883,1895,405,76,79,3
212977,1876,415,76,79,3
213388,1857,391,76,76,0
215785,1910,414,76,79,3
214491,1855,406,76,76,0
214781,1978,415,76,76,0
214988,2065,436,76,76,0
215051,1736,378,76,76,0
215064,1799,376,76,76,0
215108,2047,441,76,76,0
215119,2071,431,76,77,1
215270,1974,407,76,76,0
215399,1887,409,76,79,3
215455,1952,419,76,77,1
215689,1816,395,76,79,3
215699,1853,401,76,76,0
206654,1601,350,76,78,2
205211,1340,416,76,76,0
207557,1193,414,76,76,0
225859,1767,396,76,79,3
224396,1595,359,76,76,0
224520,1865,404,76,81,5
224540,1934,415,76,80,4
224739,2031,434,76,78,2
224869,1754,376,76,77,1
225783,1789,397,76,81,5
225863,1925,419,76,81,5
170320,2025,432,76,76,0
225951,1936,413,76,77,1
226093,1937,414,76,81,5
226229,1843,398,76,81,5
226268,2013,418,76,81,5
226377,1938,411,76,76,0
226853,1983,440,76,80,4
2147,1172,409,76,76,0
104389,1187,413,76,76,0
143121,2024,418,76,76,0
146296,1317,426,76,76,0
146963,1954,411,76,76,0
151508,1997,396,76,76,0
152554,1880,400,76,76,0
154950,2062,436,76,76,0
158625,1788,367,76,76,0
162895,1900,380,76,76,0
163264,1291,431,76,76,0
163925,1879,384,76,76,0
164859,1894,400,76,76,0
167575,1214,417,76,76,0
167959,1174,408,76,76,0
168621,2006,426,76,76,0
169705,1972,418,76,76,0
227222,1908,409,76,79,3
227234,1899,402,76,81,5
227236,2058,448,76,80,4
234574,1990,433,76,82,6
236679,1896,406,76,81,5
236276,1882,414,76,80,4
236264,1913,421,76,80,4
236221,1978,416,76,76,0
235944,1895,408,76,82,6
235875,1921,420,76,79,3
235619,1798,382,76,84,8
235424,1888,401,76,79,3
235183,1138,414,76,82,6
235149,1886,404,76,81,5
235134,1957,422,76,79,3
235008,2161,450,76,83,7
234826,1752,378,76,83,7
234711,1838,390,76,80,4
230280,1720,378,76,76,0
207715,1847,395,76,76,0
230189,1966,414,76,76,0
230065,2062,440,76,81,5
230020,2046,433,76,76,0
229862,1864,400,76,83,7
229517,1885,398,76,77,1
229469,1835,403,76,76,0
228819,1930,412,76,81,5
228789,1230,415,76,82,6
228747,1897,413,76,79,3
228708,1966,415,76,83,7
228635,1897,396,76,81,5
228579,1944,415,76,79,3
228386,1626,361,76,81,5
228092,1958,425,76,82,6
169706,1943,396,76,76,0
170370,2056,428,76,76,0
237043,2001,422,76,83,7
194794,1927,404,76,76,0
198581,1648,370,76,76,0
198368,1917,398,76,76,0
198006,2038,422,76,76,0
195668,1176,429,76,76,0
194879,1854,395,76,76,0
194845,1943,411,76,76,0
193881,1892,397,76,76,0
170719,1835,372,76,76,0
193683,1985,416,76,76,0
193352,2105,435,76,76,0
193331,1268,428,76,77,1
193116,1915,394,76,76,0
192665,1136,402,76,76,0
192641,1912,419,76,76,0
198719,1808,387,76,76,0
199393,1749,373,76,76,0
199561,1943,401,76,76,0
199577,1764,373,76,77,1
199633,1996,422,76,76,0
199745,1849,388,76,76,0
199767,2073,430,76,76,0
199813,1916,406,76,76,0
200110,1251,418,76,77,1
200316,1213,410,76,78,2
200529,2038,434,76,76,0
200677,1698,373,76,76,0
201118,2016,422,76,76,0
201144,1950,404,76,76,0
201262,2085,421,76,76,0
201389,2016,428,76,76,0
201510,2035,432,76,76,0
192593,1254,423,76,76,0
192041,1695,376,76,76,0
191627,2019,424,76,77,1
184826,2026,414,76,76,0
170733,1839,396,76,76,0
173208,2067,430,76,76,0
173474,2139,438,76,76,0
176526,1339,423,76,76,0
176930,2032,418,76,76,0
179765,2069,442,76,76,0
181318,1956,407,76,76,0
182495,1899,404,76,76,0
182945,1960,410,76,76,0
183108,2039,432,76,76,0
183130,2008,418,76,76,0
183569,1866,401,76,76,0
184144,1891,387,76,76,0
184190,1555,319,76,76,0
186098,1280,427,76,76,0
190765,2026,408,76,76,0
186156,1877,409,76,76,0
186190,2075,440,76,76,0
186200,1947,410,76,76,0
186537,1995,415,76,76,0
186627,1851,402,76,76,0
187491,1928,406,76,76,0
187735,2071,430,76,76,0
188955,1909,402,76,76,0
189060,1854,385,76,76,0
189156,1838,371,76,76,0
189251,2041,423,76,76,0
189454,1940,412,76,76,0
189712,2002,425,76,76,0
190362,1812,389,76,76,0
236920,1871,405,76,83,7
227772,1979,426,76,76,0
237135,1966,414,76,76,0
233556,1921,410,76,82,6
230348,1969,412,76,76,0
230373,1939,395,76,76,0
230425,1928,405,76,76,0
230453,1889,399,76,76,0
230457,1974,412,76,76,0
230463,1894,397,76,76,0
230475,1842,386,76,76,0
230613,1884,406,76,78,2
230975,1904,418,76,79,3
231366,1643,359,76,79,3
231390,2094,446,76,82,6
231416,1846,400,76,81,5
231936,1664,377,76,85,9
232381,1835,399,76,80,4
232498,1950,414,76,76,0
232639,1853,398,76,82,6
233301,1978,430,76,81,5
230328,1177,418,76,76,0
230318,1346,432,76,79,3
211093,2064,446,76,76,0
244373,1986,421,76,76,0
242663,1778,396,76,82,6
242664,2002,430,76,81,5
242816,1907,405,76,85,9
243007,2014,442,76,76,0
243715,1756,387,76,84,8
244261,1963,413,76,84,8
244316,1164,423,76,83,7
244374,1995,424,76,84,8
246618,1909,409,76,87,11
244380,1721,381,76,83,7
244393,1944,412,76,83,7
244749,1771,379,76,80,4
244778,1896,407,76,85,9
244915,1627,363,76,84,8
244960,1966,418,76,83,7
245388,1782,398,76,84,8
233493,1877,420,76,80,4
233631,1928,423,76,79,3
242577,2045,427,76,83,7
233848,1855,409,76,83,7
210602,1964,428,76,76,0
210679,1649,361,76,77,1
210719,1781,389,76,78,2
210896,2116,444,76,77,1
257179,1676,378,76,86,10
256790,1736,379,76,88,12
253290,1982,428,76,82,6
253124,1987,430,76,85,9
253072,1961,425,76,85,9
253004,1814,391,76,90,14
251804,1974,432,76,85,9
251566,1883,412,76,88,12
251528,1782,396,76,83,7
251221,2042,432,76,80,4
247641,1808,402,76,86,10
246791,1829,398,76,86,10
211368,1895,404,76,77,1
210438,1796,377,76,76,0
210384,1993,432,76,76,0
210282,2024,431,76,76,0
208224,1953,411,76,76,0
233959,1797,402,76,79,3
234078,1947,419,76,81,5
234171,1805,389,76,79,3
237184,2005,431,76,82,6
208001,1932,420,76,77,1
208045,1968,422,76,76,0
208053,1889,394,76,76,0
208250,2009,420,76,76,0
210047,2011,414,76,77,1
208375,1150,404,76,79,3
208498,1877,387,76,76,0
208509,1999,423,76,77,1
208787,2052,425,76,77,1
209039,1858,397,76,76,0
209329,1830,392,76,79,3
209744,1945,424,76,76,0
242578,1706,374,76,84,8
230317,1129,405,76,76,0
242380,1992,418,76,82,6
240273,1776,386,76,86,10
241497,1918,415,76,80,4
241187,1882,418,76,84,8
240915,1925,417,76,84,8
240754,2067,447,76,80,4
240716,1895,412,76,84,8
240458,1925,405,76,82,6
239956,1836,395,76,85,9
242374,1795,397,76,83,7
239890,1707,382,76,85,9
239580,1637,363,76,82,6
238227,1959,422,76,83,7
238095,1720,389,76,83,7
238033,1081,403,76,76,0
237646,1881,417,76,80,4
241707,1850,405,76,83,7
211108,1922,412,76,76,0
242348,1826,389,76,77,1
242118,1980,425,76,82,6
241907,1820,388,76,84,8
231826,1800,387,75,79,4
224510,2001,413,75,75,0
183714,1744,368,75,75,0
158626,2027,423,75,75,0
215202,1909,402,75,75,0
213666,1924,416,75,78,3
190113,1290,434,75,75,0
244385,1022,399,75,79,4
239529,1985,439,75,81,6
184575,2010,424,75,75,0
203775,1243,428,75,76,1
198143,1838,385,75,75,0
240289,1870,395,75,79,4
226045,2007,437,75,76,1
232099,2016,429,75,80,5
198653,1119,408,75,75,0
229628,1856,394,75,77,2
156412,1192,407,75,75,0
237819,2011,434,75,83,8
204539,2100,451,75,75,0
213242,1956,419,75,76,1
211706,1910,409,75,75,0
189433,1585,325,75,75,0
204451,1655,362,75,77,2
215716,1771,376,75,76,1
241827,1718,372,75,80,5
198032,1635,356,75,75,0
186351,1985,423,75,75,0
244206,1498,325,75,84,9
231150,1971,429,75,75,0
221422,1780,377,75,77,2
216814,2027,421,75,76,1
189165,1984,404,75,75,0
208621,2006,428,75,75,0
185068,2008,426,75,75,0
243854,1745,382,75,85,10
204688,2074,431,75,75,0
241042,1773,383,75,85,10
216466,1967,417,75,75,0
204713,2000,422,75,75,0
213928,1999,426,75,77,2
184999,2078,434,75,75,0
231591,1947,413,75,77,2
237221,1869,399,75,83,8
205989,1923,412,75,77,2
189860,1969,413,75,75,0
235172,1928,418,75,85,10
189177,2088,437,75,75,0
190456,1938,412,75,75,0
178424,2071,430,75,75,0
236699,1981,417,75,80,5
191135,1811,404,75,75,0
225439,1999,419,75,81,6
221342,1880,418,75,82,7
251805,1882,420,75,86,11
228509,1956,420,75,82,7
213917,1662,363,75,78,3
211101,1219,427,75,79,4
231836,1890,392,75,82,7
213404,1779,384,75,78,3
192667,1964,438,75,75,0
194201,1655,369,75,75,0
176376,1895,403,75,75,0
215449,2108,439,75,78,3
214169,1666,372,75,75,0
230295,1843,405,75,75,0
199575,1347,430,75,75,0
213654,1973,429,75,80,5
211862,1992,422,75,75,0
219797,1885,411,75,76,1
211348,1200,411,75,79,4
217235,1867,384,75,75,0
215443,1901,415,75,76,1
165536,1602,326,75,75,0
200353,1657,356,75,76,1
232097,1816,386,75,81,6
234913,1877,403,75,75,0
198904,1534,329,75,75,0
226807,2079,438,75,78,3
225782,1979,434,75,81,6
221430,1856,398,75,76,1
215798,2100,449,75,78,3
199158,1938,412,75,75,0
161938,1807,378,75,75,0
238581,1944,417,75,83,8
247028,2070,442,75,83,8
237556,1619,373,75,77,2
230388,1651,363,75,75,0
218868,2102,444,75,75,0
216820,1879,406,75,76,1
212212,1921,426,75,76,1
245235,1983,435,75,81,6
240115,1677,371,75,80,5
253170,1659,374,75,83,8
255472,1851,390,75,81,6
216816,1871,390,75,78,3
198640,1885,391,75,75,0
252143,2009,417,75,84,9
183285,1649,351,75,75,0
244385,1022,399,75,79,4
216158,1989,430,75,75,0
215135,1716,370,75,75,0
235997,1951,413,75,82,7
236007,1759,380,75,80,5
236073,1839,387,75,75,0
236245,1859,407,75,78,3
236298,1977,410,75,82,7
236461,1722,375,75,80,5
236699,1981,417,75,80,5
236804,1760,390,75,80,5
236817,1917,407,75,78,3
236898,1990,427,75,80,5
236899,1802,389,75,80,5
237034,1905,411,75,81,6
237221,1869,399,75,83,8
237321,1885,406,75,80,5
237329,1951,423,75,83,8
237556,1619,373,75,77,2
237626,1915,408,75,80,5
237681,1821,393,75,88,13
237819,2011,434,75,83,8
237841,1970,425,75,78,3
237960,2000,432,75,77,2
238305,1845,407,75,78,3
238370,1596,364,75,81,6
238581,1944,417,75,83,8
238858,1911,404,75,81,6
239335,1875,393,75,84,9
239529,1985,439,75,81,6
235883,1957,427,75,84,9
235634,1888,411,75,78,3
235565,1933,411,75,78,3
183895,1906,394,75,75,0
176733,1829,387,75,75,0
229980,1799,381,75,83,8
247131,1928,421,75,75,0
242267,1788,389,75,81,6
207707,1952,416,75,75,0
205402,1927,403,75,76,1
183129,1741,359,75,75,0
194904,1188,409,75,75,0
253272,1176,397,75,77,2
221016,1967,411,75,75,0
134744,1971,413,75,75,0
185431,1811,383,75,75,0
201303,2062,437,75,75,0
225363,1939,404,75,76,1
192086,1959,411,75,75,0
185174,1992,414,75,75,0
221014,1769,384,75,80,5
201046,1825,389,75,75,0
223061,1923,404,75,75,0
221269,1923,403,75,78,3
261204,1806,388,75,75,0
194644,1991,417,75,75,0
248148,1939,412,75,85,10
219732,1857,402,75,76,1
193107,1114,413,75,75,0
180819,1997,412,75,75,0
239592,1699,368,75,84,9
239795,1873,408,75,75,0
239837,1995,415,75,82,7
202089,1305,416,75,75,0
243854,1745,382,75,85,10
244206,1498,325,75,84,9
245235,1983,435,75,81,6
245426,1599,343,75,81,6
185195,1905,399,75,75,0
235883,1957,427,75,84,9
215147,1658,368,75,77,2
242794,1876,391,75,81,6
231786,1775,378,75,76,1
230250,2035,424,75,75,0
202858,1958,428,75,75,0
210281,1866,396,75,75,0
230502,1789,380,75,75,0
243631,1884,403,75,80,5
191076,2028,419,75,75,0
230244,1913,406,75,75,0
229476,1781,388,75,78,3
221284,1757,383,75,76,1
171875,2128,433,75,75,0
236899,1802,389,75,80,5
236898,1990,427,75,80,5
203362,1994,420,75,75,0
203106,2004,413,75,75,0
246113,1967,433,75,82,7
252000,1904,415,75,81,6
202848,1745,374,75,75,0
243656,1793,393,75,78,3
243627,1974,414,75,81,6
189296,1100,392,75,75,0
241026,1899,404,75,84,9
199792,2071,436,75,75,0
214639,1662,371,75,75,0
207471,1946,410,75,75,0
259694,1798,393,75,83,8
193133,1995,433,75,75,0
188268,1990,414,75,75,0
230252,1923,409,75,75,0
190059,2055,440,75,75,0
240060,1800,403,75,83,8
240115,1677,371,75,80,5
240289,1870,395,75,79,4
240654,1828,398,75,81,6
241042,1773,383,75,85,10
243414,1898,413,75,80,5
241470,1882,410,75,85,10
241673,2020,429,75,75,0
241686,1928,401,75,80,5
241827,1718,372,75,80,5
241990,1807,394,75,75,0
242236,1657,359,75,81,6
242267,1788,389,75,81,6
242392,1594,358,75,80,5
242619,1912,417,75,80,5
242794,1876,391,75,81,6
243231,2084,451,75,81,6
243245,1971,420,75,83,8
224425,2025,442,75,76,1
212432,1167,412,75,75,0
215466,1559,341,75,75,0
213689,1879,408,75,78,3
215228,1655,337,75,75,0
192955,1994,421,75,75,0
242619,1912,417,75,80,5
231355,1951,423,75,82,7
153275,1202,418,75,75,0
211899,1869,398,75,75,0
210619,2002,417,75,76,1
219576,1970,424,75,75,0
224444,1880,395,75,77,2
204472,2051,431,75,75,0
186551,2039,435,75,75,0
228279,1333,427,75,81,6
223671,1541,343,75,79,4
211382,1900,408,75,76,1
200630,1943,416,75,75,0
252084,1815,396,75,81,6
220604,1379,428,75,75,0
247246,1983,431,75,83,8
207807,1933,404,75,75,0
186347,2058,429,75,75,0
191164,1877,401,75,75,0
240060,1800,403,75,83,8
231612,1929,400,75,78,3
232938,1754,385,75,85,10
237034,1905,411,75,81,6
173546,1520,314,75,75,0
214763,1891,391,75,75,0
245940,1897,420,75,84,9
247131,1928,421,75,75,0
246098,1598,360,75,78,3
246113,1967,433,75,82,7
246191,1960,413,75,85,10
246836,1626,358,75,79,4
246960,1877,401,75,85,10
247028,2070,442,75,83,8
247103,1961,420,75,85,10
245940,1897,420,75,84,9
239795,1873,408,75,75,0
172723,1220,421,75,75,0
205431,1817,379,75,75,0
230005,1952,417,75,79,4
190581,1975,415,75,75,0
263286,1028,399,75,76,1
200054,1929,408,75,75,0
209782,1878,398,75,75,0
234102,1142,415,75,80,5
263287,1853,397,75,75,0
213367,1892,408,75,76,1
230323,1116,395,75,75,0
157304,1824,380,75,75,0
226168,1993,425,75,81,6
207993,1971,433,75,75,0
225147,1816,401,75,78,3
225403,2043,435,75,78,3
169595,1985,418,75,75,0
177019,1714,357,75,75,0
229749,1838,389,75,78,3
225653,1872,411,75,77,2
157301,1931,418,75,75,0
209781,2064,427,75,75,0
245426,1599,343,75,81,6
223922,2033,422,75,75,0
204977,1929,407,75,75,0
246960,1877,401,75,85,10
246191,1960,413,75,85,10
243631,1884,403,75,80,5
211119,2022,423,75,75,0
207790,1970,407,75,78,3
236461,1722,375,75,80,5
192427,2032,419,75,75,0
243627,1974,414,75,81,6
237681,1821,393,75,88,13
235634,1888,411,75,78,3
142707,1944,397,75,75,0
190324,1748,381,75,75,0
254909,2044,430,75,82,7
158144,1952,399,75,75,0
228732,1546,339,75,80,5
220876,1898,401,75,77,2
230354,1937,404,75,75,0
180175,1895,397,75,75,0
219087,1898,412,75,82,7
247246,1983,431,75,83,8
233934,1258,420,75,82,7
202445,1476,332,75,78,3
198861,1952,409,75,75,0
235467,2042,435,75,77,2
215251,1316,431,75,76,1
231627,1742,390,75,81,6
210635,1730,378,75,77,2
201931,1181,406,75,76,1
229034,2077,439,75,78,3
223197,1889,398,75,81,6
235997,1951,413,75,82,7
239837,1995,415,75,82,7
192722,1948,402,75,75,0
226515,1913,403,75,75,0
230336,1843,388,75,75,0
242392,1594,358,75,80,5
222429,1916,395,75,79,4
262621,1051,424,75,83,8
216283,1969,416,75,75,0
205531,2036,424,75,76,1
224218,1860,398,75,78,3
229593,1888,403,75,76,1
220633,1790,396,75,78,3
153048,1847,376,75,75,0
230355,1957,416,75,75,0
210648,1505,330,75,75,0
210136,1854,401,75,76,1
203736,1740,378,75,75,0
243414,1898,413,75,80,5
236245,1859,407,75,78,3
189908,1169,410,75,76,1
225748,1809,380,75,82,7
223710,1669,363,75,76,1
232670,1731,377,75,75,0
195038,1890,396,75,75,0
225733,1902,406,75,75,0
243656,1793,393,75,78,3
247495,1898,412,75,85,10
171975,1731,357,75,75,0
227527,1768,380,75,75,0
221639,1970,410,75,75,0
216774,1781,379,75,77,2
230341,1802,394,75,75,0
221125,1842,396,75,79,4
221919,1836,395,75,76,1
171972,1986,412,75,75,0
232132,1776,386,75,82,7
222148,1973,406,75,78,3
225475,1989,419,75,78,3
234178,1742,377,75,80,5
221634,1893,400,75,76,1
149185,1861,387,75,75,0
205257,1884,395,75,75,0
186569,1141,401,75,75,0
199626,2066,427,75,75,0
216266,1863,404,75,78,3
230625,1891,409,75,78,3
169697,1198,408,75,75,0
238305,1845,407,75,78,3
163301,1531,435,75,75,0
253157,2014,433,75,82,7
196069,2028,431,75,75,0
173030,2121,443,75,75,0
208615,1765,393,75,77,2
213991,2048,430,75,77,2
221671,1885,394,75,75,0
236007,1759,380,75,80,5
239335,1875,393,75,84,9
239592,1699,368,75,84,9
220905,1890,416,75,78,3
226537,1870,402,75,76,1
197756,1973,416,75,75,0
214132,1947,430,75,75,0
247328,2030,428,75,83,8
230423,1978,414,75,75,0
233866,1965,423,75,83,8
213899,1814,395,75,76,1
228236,1767,387,75,76,1
189324,1246,421,75,75,0
223885,1195,419,75,80,5
230401,1697,357,75,75,0
230427,1801,389,75,75,0
231227,1992,424,75,80,5
230502,1789,380,75,75,0
230524,1745,371,75,75,0
230528,1717,363,75,75,0
230625,1891,409,75,78,3
230727,1261,424,75,78,3
230967,1909,405,75,75,0
225161,1718,374,75,79,4
209289,1937,411,75,76,1
237960,2000,432,75,77,2
208520,1899,407,75,75,0
204936,1740,378,75,77,2
179847,1537,332,75,75,0
220295,1984,422,75,75,0
193158,2023,414,75,75,0
188038,1881,400,75,75,0
201862,1891,395,75,75,0
229764,2008,434,75,81,6
216452,1833,376,75,76,1
201860,1643,346,75,75,0
183427,2015,417,75,75,0
195202,1973,416,75,75,0
241026,1899,404,75,84,9
205953,2017,429,75,75,0
247495,1898,412,75,85,10
231355,1951,423,75,82,7
230528,1717,363,75,75,0
234913,1877,403,75,75,0
234045,1854,396,75,80,5
234102,1142,415,75,80,5
234111,1990,423,75,83,8
234178,1742,377,75,80,5
234789,1850,399,75,83,8
234824,1837,400,75,78,3
235172,1928,418,75,85,10
231591,1947,413,75,77,2
235389,1958,419,75,82,7
235467,2042,435,75,77,2
178091,1721,376,75,75,0
172203,1195,394,75,75,0
222123,1792,396,75,77,2
210603,1971,420,75,75,0
233934,1258,420,75,82,7
233866,1965,423,75,83,8
233290,1806,395,75,78,3
233267,1173,407,75,77,2
233029,2087,443,75,75,0
232938,1754,385,75,85,10
232670,1731,377,75,75,0
232241,2022,427,75,75,0
232223,1978,425,75,79,4
232132,1776,386,75,82,7
232099,2016,429,75,80,5
232097,1816,386,75,81,6
231836,1890,392,75,82,7
231826,1800,387,75,79,4
231786,1775,378,75,76,1
231627,1742,390,75,81,6
231612,1929,400,75,78,3
193152,1230,418,75,75,0
231150,1971,429,75,75,0
234111,1990,423,75,83,8
251470,1998,430,75,85,10
263287,1853,397,75,75,0
216447,1797,375,75,75,0
253272,1176,397,75,77,2
253170,1659,374,75,83,8
253157,2014,433,75,82,7
252931,2014,430,75,83,8
252143,2009,417,75,84,9
252084,1815,396,75,81,6
248148,1939,412,75,85,10
251182,1911,418,75,79,4
251517,1966,429,75,87,12
230005,1952,417,75,79,4
252000,1904,415,75,81,6
251805,1882,420,75,86,11
263286,1028,399,75,76,1
262621,1051,424,75,83,8
261204,1806,388,75,75,0
259694,1798,393,75,83,8
257536,1905,406,75,80,5
256769,1921,412,75,83,8
255472,1851,390,75,81,6
254909,2044,430,75,82,7
229764,2008,434,75,81,6
229980,1799,381,75,83,8
230165,1224,417,75,75,0
230336,1843,388,75,75,0
229758,2036,427,75,75,0
200318,1946,406,75,75,0
251517,1966,429,75,87,12
235389,1958,419,75,82,7
221053,1943,421,75,75,0
213629,2053,419,75,77,2
230524,1745,371,75,75,0
230388,1651,363,75,75,0
230355,1957,416,75,75,0
230354,1937,404,75,75,0
230341,1802,394,75,75,0
230323,1116,395,75,75,0
230295,1843,405,75,75,0
230252,1923,409,75,75,0
230250,2035,424,75,75,0
230244,1913,406,75,75,0
230224,1674,350,75,75,0
230219,1949,413,75,75,0
230213,1875,413,75,75,0
230202,1900,401,75,75,0
230195,1234,401,75,75,0
230186,1850,397,75,75,0
254487,1942,411,75,83,8
214665,1940,423,74,74,0
199339,1434,414,74,74,0
200875,1791,373,74,74,0
237995,1878,396,74,83,9
247181,1862,402,74,84,10
178090,1851,385,74,74,0
225706,1958,411,74,74,0
236457,1865,402,74,78,4
206218,1144,413,74,78,4
229804,1778,384,74,75,1
194957,1703,359,74,74,0
218540,1974,427,74,74,0
211381,1768,373,74,74,0
230829,1803,401,74,80,6
237997,1689,371,74,80,6
200446,1920,401,74,74,0
188414,1873,377,74,74,0
225926,1832,395,74,74,0
190854,1791,379,74,74,0
198023,1879,399,74,74,0
216199,1612,347,74,75,1
178567,1874,391,74,74,0
238216,1889,411,74,82,8
205193,1730,374,74,77,3
219536,1732,376,74,78,4
256948,1890,399,74,87,13
230324,1073,386,74,74,0
252339,1765,399,74,82,8
236466,1875,399,74,78,4
234930,1975,418,74,77,3
230320,1154,409,74,74,0
212911,1828,394,74,74,0
253102,1862,399,74,82,8
206254,1926,405,74,74,0
211856,1728,391,74,76,2
211099,1836,399,74,74,0
224656,1954,428,74,78,4
246672,1716,367,74,83,9
257439,1410,413,74,77,3
225696,1812,391,74,75,1
227232,1946,411,74,74,0
252064,1891,413,74,81,7
193440,1848,399,74,74,0
193532,1885,391,74,74,0
226721,1251,417,74,76,2
240033,1812,395,74,75,1
241569,1911,410,74,81,7
214436,1925,413,74,77,3
224933,1802,384,74,74,0
225701,1235,409,74,74,0
231077,2027,429,74,74,0
240037,1854,386,74,77,3
252837,1861,397,74,86,12
205990,1945,412,74,79,5
216742,1734,377,74,74,0
218534,1849,400,74,74,0
219814,2013,431,74,74,0
239015,1875,403,74,79,5
194728,1846,391,74,74,0
244383,1477,322,74,78,4
231838,1825,397,74,80,6
182941,1743,368,74,74,0
237207,1830,387,74,78,4
210321,1872,402,74,74,0
205970,1924,406,74,74,0
239250,1776,386,74,83,9
178322,2054,436,74,74,0
242835,1709,378,74,82,8
230293,1856,399,74,74,0
212118,1937,401,74,76,2
226710,1741,372,74,84,10
208535,2005,427,74,74,0
186519,1836,388,74,74,0
189084,1264,406,74,74,0
222104,1608,359,74,82,8
182168,1545,327,74,74,0
199833,1090,400,74,74,0
233113,1893,407,74,79,5
186521,1657,342,74,74,0
211098,1980,420,74,75,1
222875,1956,428,74,75,1
231835,1791,382,74,75,1
229788,2084,431,74,74,0
167933,1768,354,74,74,0
230370,1745,391,74,74,0
187132,1757,379,74,74,0
240938,1813,390,74,74,0
217648,1852,395,74,74,0
207920,1884,404,74,74,0
205360,1972,408,74,74,0
230191,1195,410,74,74,0
221743,1772,382,74,74,0
192557,2005,414,74,74,0
189485,1821,385,74,74,0
189484,1933,405,74,74,0
220715,1830,389,74,80,6
210475,1777,387,74,74,0
220714,1987,421,74,79,5
233265,1863,390,74,77,3
218154,1959,419,74,74,0
189225,1937,407,74,74,0
197900,1976,425,74,74,0
199692,1732,367,74,74,0
192270,1915,405,74,74,0
197136,1903,399,74,74,0
203280,1916,391,74,74,0
223248,1821,381,74,74,0
195088,1910,400,74,74,0
219409,1966,415,74,75,1
230449,1706,341,74,74,0
257073,1771,386,74,82,8
230417,2008,421,74,74,0
230198,1874,395,74,76,2
211005,1655,366,74,74,0
203581,1904,406,74,74,0
230972,1798,376,74,76,2
180283,1953,397,74,74,0
193338,1759,365,74,74,0
193849,2019,413,74,74,0
180281,1978,415,74,74,0
236600,1798,394,74,84,10
244791,2041,423,74,74,0
230199,1817,391,74,74,0
244789,1845,391,74,76,2
204850,1828,405,74,75,1
201269,1120,408,74,74,0
244788,2009,420,74,81,7
238900,1777,384,74,81,7
232244,1833,387,74,79,5
225844,1862,386,74,77,3
205364,1985,421,74,74,0
216627,1831,400,74,74,0
244274,1056,392,74,77,3
222514,1158,409,74,81,7
205362,1759,361,74,74,0
221201,2022,423,74,75,1
206098,1864,404,74,75,1
190459,1258,403,74,74,0
192546,1821,397,74,74,0
237086,1687,377,74,81,7
211999,1725,366,74,75,1
186143,1983,394,74,74,0
204320,1968,407,74,74,0
226592,1981,420,74,77,3
227873,1887,420,74,77,3
195361,1901,400,74,74,0
137506,1850,369,74,74,0
210722,1769,372,74,74,0
235042,2022,408,74,74,0
183332,1833,388,74,74,0
189725,1943,402,74,74,0
198949,1974,425,74,74,0
226085,1188,402,74,78,4
230437,2038,428,74,74,0
235813,2023,418,74,78,4
243237,1843,404,74,82,8
231207,1659,370,74,82,8
235047,1852,395,74,74,0
254247,1815,388,74,81,7
191783,2033,424,74,74,0
248872,2032,435,74,79,5
200478,2023,424,74,74,0
187421,1989,412,74,74,0
235026,1788,392,74,82,8
186392,1799,387,74,74,0
212755,1923,408,74,76,2
224019,1853,394,74,78,4
210964,1681,368,74,75,1
235029,1795,385,74,80,6
207894,1751,366,74,74,0
234774,1959,409,74,74,0
188182,1756,386,74,74,0
236311,1928,417,74,76,2
206104,1750,371,74,74,0
247832,1876,411,74,80,6
186648,1746,384,74,74,0
246045,1984,424,74,86,12
255000,1692,370,74,82,8
162329,1916,397,74,74,0
215322,1987,418,74,75,1
225562,1939,409,74,75,1
245275,1966,411,74,79,5
186395,2053,423,74,74,0
210972,1838,387,74,75,1
219932,1841,384,74,79,5
230173,1189,404,74,74,0
238621,1540,331,74,78,4
231485,1805,394,74,81,7
237629,1842,410,74,82,8
227647,1946,421,74,79,5
246748,1878,408,74,81,7
231640,1815,388,74,80,6
226777,1700,378,74,75,1
230361,1864,390,74,74,0
251353,1822,384,74,74,0
199386,1965,406,74,74,0
234458,1538,335,74,74,0
224987,1192,403,74,76,2
245211,1843,411,74,81,7
235996,1876,409,74,74,0
244700,993,388,74,74,0
186589,1886,395,74,74,0
209620,1877,411,74,75,1
253149,1906,420,74,84,10
192991,1893,388,74,74,0
193247,1137,406,74,74,0
183520,2018,417,74,74,0
201953,2046,430,74,74,0
216033,1184,404,74,74,0
238050,1783,400,74,81,7
239842,1719,367,74,77,3
204771,1969,423,74,74,0
220131,1681,360,74,74,0
204757,2031,425,74,74,0
201939,1807,396,74,74,0
233791,1053,410,74,81,7
190156,1909,397,74,74,0
224251,1212,424,74,77,3
189946,1875,382,74,74,0
237560,1871,397,74,80,6
230392,1888,397,74,74,0
210423,1924,402,74,75,1
216054,1918,405,74,74,0
200438,1984,421,74,74,0
189172,1936,403,74,74,0
251892,1678,369,74,81,7
230326,1863,398,74,74,0
226765,1856,398,74,74,0
184274,1754,381,74,74,0
177358,1908,395,74,74,0
138703,1786,353,74,74,0
222671,1888,403,74,74,0
241103,1771,383,74,82,8
198352,1546,327,74,74,0
211408,1944,417,74,76,2
190416,1945,416,74,74,0
230353,1989,425,74,74,0
218066,1856,392,74,74,0
236498,1810,388,74,78,4
237539,1826,383,74,78,4
216036,2109,443,74,74,0
225252,1774,381,74,74,0
193091,1560,327,74,74,0
243952,1114,401,74,85,11
178160,2008,404,74,74,0
236527,1888,405,74,80,6
229359,1970,418,74,74,0
224494,1841,401,74,79,5
208622,1831,391,74,74,0
203502,1985,416,74,74,0
233965,2037,428,74,78,4
230468,1847,388,74,74,0
204612,2076,431,74,75,1
215363,1162,404,74,80,6
188388,1901,390,74,74,0
215107,1918,412,74,74,0
208451,1921,405,74,75,1
204355,1812,380,74,74,0
230978,1787,390,74,79,5
227394,1717,365,74,74,0
231745,1856,401,74,79,5
230465,1764,373,74,74,0
216385,2040,435,74,74,0
205633,2012,418,74,74,0
169792,1874,391,74,74,0
203505,2027,424,74,74,0
237297,1539,334,74,77,3
242418,1812,391,74,84,10
199667,1803,384,74,74,0
199909,1062,391,74,74,0
220901,1297,417,74,78,4
234725,1904,419,74,80,6
244197,1769,390,74,74,0
184037,1696,358,74,74,0
243686,1908,399,74,77,3
240359,1850,395,74,80,6
226536,1591,354,74,75,1
162280,1992,414,74,74,0
241130,1782,392,74,79,5
215531,2032,423,74,74,0
208620,1922,401,74,74,0
246764,1970,425,74,83,9
253932,1798,386,74,74,0
230381,1968,419,74,74,0
188938,1191,415,74,74,0
223243,1756,364,74,74,0
238068,1746,376,74,78,4
220148,1782,389,74,75,1
226035,1916,419,74,74,0
225523,1968,427,74,74,0
212406,1158,413,74,77,3
231236,1915,400,74,78,4
205495,1808,395,74,74,0
188770,1922,400,74,74,0
252935,1871,398,74,83,9
236295,1868,391,74,78,4
224263,1915,396,74,75,1
232709,1917,420,74,77,3
239872,1621,355,74,75,1
239360,1686,363,74,83,9
231524,1994,422,74,79,5
231012,1812,372,74,74,0
221540,1769,373,74,74,0
230497,1763,377,74,74,0
225646,2065,442,74,74,0
230240,1912,405,74,74,0
194911,1244,409,74,74,0
243551,1894,408,74,76,2
240223,1868,412,74,77,3
230239,2010,421,74,74,0
207454,1794,374,74,74,0
202078,2039,436,74,74,0
188253,1930,399,74,74,0
230237,1969,408,74,74,0
207624,1637,359,74,77,3
215048,1238,408,74,74,0
226568,1899,401,74,82,8
239368,1870,409,74,81,7
169324,1982,416,74,74,0
223596,1783,377,74,77,3
215148,1872,397,74,74,0
230507,1878,396,74,74,0
239978,1947,419,74,83,9
190569,1238,405,74,74,0
241769,978,388,74,74,0
219496,1631,349,74,74,0
232294,1986,413,74,74,0
223334,1854,404,74,78,4
183141,1253,411,74,74,0
241509,1887,398,74,80,6
230245,1804,401,74,74,0
170084,1171,413,74,74,0
230327,1580,351,74,74,0
214026,1998,437,74,74,0
234505,2013,424,74,81,7
210697,1932,406,74,76,2
208137,1803,378,74,77,3
213597,1933,415,74,75,1
236636,1872,402,74,80,6
224348,1424,423,74,74,0
214350,1810,373,74,74,0
196942,1970,407,74,74,0
234573,1979,429,74,78,4
202061,2047,425,74,74,0
236108,1916,405,74,74,0
234827,1676,360,74,81,7
253002,1764,371,74,88,14
231242,1908,408,74,78,4
192073,1998,418,74,74,0
253257,1718,377,74,84,10
247881,1840,409,74,77,3
234569,1784,382,74,83,9
230217,1976,418,74,74,0
221001,1994,432,74,74,0
205897,1897,406,74,76,2
179783,1127,385,74,74,0
179527,1843,382,74,74,0
211269,1980,424,74,74,0
243780,1870,386,74,82,8
193738,2073,426,74,74,0
206414,1688,362,74,74,0
215886,2020,411,74,74,0
229723,1964,411,74,77,3
226382,1941,416,74,74,0
220763,1967,418,74,76,2
235866,1834,398,74,80,6
222041,1889,410,74,79,5
241496,1889,407,74,81,7
203864,1972,418,74,75,1
192087,1949,412,74,74,0
210007,1922,391,74,75,1
230230,1793,367,74,74,0
225878,1917,408,74,74,0
183125,1865,376,74,74,0
230229,1772,366,74,74,0
203604,1974,415,74,74,0
230227,1766,378,74,74,0
215123,1219,405,74,74,0
251217,1989,427,74,80,6
227153,1854,413,74,74,0
226385,1832,400,74,74,0
240976,2016,428,74,79,5
231247,2019,436,74,81,7
253293,1910,409,74,83,9
241867,1780,398,74,77,3
213884,2054,441,74,77,3
255106,1578,357,74,82,8
212591,1715,366,74,76,2
211567,1920,416,74,74,0
256632,1797,402,74,82,8
228729,1705,364,74,75,1
231545,1061,404,74,79,5
200826,1736,365,74,74,0
221306,1870,396,74,74,0
235899,1839,405,74,79,5
245371,1985,421,74,86,12
238717,1706,375,74,75,1
207998,1183,406,74,74,0
221310,1952,412,74,74,0
201343,1520,329,74,74,0
161663,1262,404,74,74,0
237183,1983,418,74,77,3
192129,1224,409,74,74,0
225410,1772,383,74,75,1
225647,1273,412,74,74,0
230255,1918,409,74,74,0
172143,1995,385,74,74,0
209523,1914,405,74,74,0
237679,1747,381,74,83,9
206198,1696,367,74,75,1
215157,1937,410,74,74,0
211061,1836,378,74,74,0
164468,1640,345,74,74,0
192371,1996,421,74,74,0
224883,1850,392,74,75,1
205427,1873,406,74,74,0
223608,1911,407,74,74,0
183666,1272,411,74,74,0
215410,1714,356,74,77,3
198513,1277,414,74,76,2
231280,1869,409,74,75,1
244591,1862,411,74,85,11
178031,1731,361,74,74,0
204152,1892,407,74,74,0
230274,1815,380,74,74,0
230529,1815,396,74,74,0
216451,2030,418,74,74,0
234686,1851,399,74,79,5
219585,1755,379,74,80,6
200641,1861,391,74,74,0
132740,1342,412,74,74,0
233152,1714,379,74,80,6
193470,1928,411,74,74,0
186302,1913,401,74,74,0
241854,1926,415,74,83,9
235454,1886,403,74,78,4
190653,1902,409,74,74,0
225474,2006,434,74,74,0
198077,1857,383,74,74,0
184252,1979,419,74,74,0
236988,1714,369,74,81,7
220348,1967,418,74,74,0
219835,1844,385,74,74,0
214971,1859,402,74,74,0
198331,1923,400,74,74,0
165560,1877,395,74,74,0
178625,1905,384,74,74,0
237248,1796,389,74,82,8
235970,1705,367,74,79,5
239048,1825,395,74,74,0
230021,1538,343,74,79,5
227274,1824,394,74,75,1
207562,1691,357,74,74,0
253385,1751,373,74,81,7
207555,1538,330,74,76,2
227785,1859,405,74,74,0
202697,1757,372,74,76,2
231113,1778,390,74,77,3
189127,1678,365,74,74,0
213446,1993,427,74,74,0
231108,1880,403,74,80,6
230084,1879,411,74,81,7
230339,1890,419,74,74,0
150724,1228,411,74,74,0
255687,1711,380,74,81,7
193512,1153,403,73,73,0
234986,1644,361,73,79,6
226539,1826,389,73,73,0
191210,1956,411,73,73,0
246762,1923,410,73,82,9
207593,1931,409,73,74,1
223978,1875,390,73,82,9
181481,1183,403,73,73,0
228332,1823,385,73,77,4
259816,1888,408,73,86,13
247019,1627,357,73,79,6
215069,1216,409,73,74,1
236524,1702,376,73,82,9
177644,1312,407,73,73,0
245228,1689,377,73,82,9
216813,1984,414,73,73,0
239342,1196,415,73,78,5
241390,1929,416,73,83,10
251886,1737,376,73,79,6
191726,1818,388,73,73,0
188400,1225,403,73,75,2
205553,1441,306,73,73,0
212456,1938,412,73,73,0
234728,1902,390,73,77,4
216793,1687,371,73,73,0
205288,1220,403,73,73,0
229595,1870,401,73,79,6
230366,1848,385,73,73,0
241117,1875,396,73,76,3
208861,1902,401,73,73,0
237532,2008,420,73,73,0
230364,1948,408,73,73,0
222428,1635,360,73,80,7
230107,1928,416,73,78,5
227803,1735,381,73,73,0
199912,1855,389,73,73,0
199131,1871,406,73,73,0
161754,1876,387,73,73,0
167665,1875,377,73,73,0
228312,1924,411,73,73,0
221912,1164,402,73,75,2
212183,1936,401,73,73,0
201943,1732,373,73,73,0
209888,1977,423,73,73,0
251616,1404,306,73,83,10
193504,1636,354,73,73,0
212449,1657,346,73,73,0
188135,1984,416,73,73,0
222951,1171,409,73,80,7
236518,1785,387,73,78,5
229348,1839,405,73,80,7
153060,1767,372,73,73,0
192227,1835,384,73,73,0
236515,1139,407,73,82,9
225507,1895,403,73,73,0
221923,1822,399,73,74,1
201955,1888,406,73,73,0
189410,1963,404,73,73,0
215522,1113,392,73,77,4
228321,1852,407,73,78,5
157665,1475,309,73,73,0
216289,2021,417,73,73,0
206577,1988,406,73,73,0
165531,1891,405,73,73,0
214770,1948,418,73,73,0
192930,1867,398,73,73,0
246174,1687,361,73,87,14
224415,1759,372,73,73,0
235167,1890,408,73,80,7
236703,1902,419,73,80,7
191648,1685,352,73,73,0
258208,1968,411,73,80,7
211361,1997,417,73,74,1
216481,1562,336,73,76,3
237985,1609,358,73,79,6
259233,1861,409,73,85,12
214434,1788,389,73,73,0
232610,1787,387,73,73,0
251810,1760,386,73,85,12
211107,1576,338,73,75,2
225182,1842,387,73,74,1
223139,1792,396,73,76,3
225699,1952,417,73,77,4
182179,1502,327,73,73,0
214692,1840,382,73,73,0
214948,1691,359,73,75,2
152996,1874,386,73,73,0
201893,1923,391,73,73,0
190885,1926,409,73,73,0
213414,1521,334,73,75,2
236454,1815,398,73,78,5
197031,1803,376,73,73,0
211879,1902,397,73,74,1
224423,1980,415,73,76,3
236190,1677,360,73,73,0
241821,1715,365,73,80,7
172018,1632,329,73,73,0
212888,1563,352,73,75,2
236690,1641,359,73,73,0
236947,1717,385,73,81,8
237715,1718,367,73,78,5
246419,1833,378,73,83,10
183187,1900,397,73,73,0
190868,1868,405,73,73,0
199829,1923,389,73,73,0
212886,2089,436,73,74,1
190870,1594,355,73,73,0
200855,1829,398,73,73,0
246423,1801,392,73,83,10
192663,1763,377,73,73,0
201368,1986,416,73,73,0
214680,1180,403,73,75,2
219293,1696,366,73,76,3
229528,1779,390,73,80,7
200601,1966,412,73,73,0
224921,1786,387,73,78,5
187033,1484,315,73,73,0
176794,1867,376,73,73,0
247450,1924,407,73,78,5
192922,1153,392,73,73,0
227227,1778,385,73,73,0
236246,1921,415,73,80,7
169115,1657,337,73,73,0
264348,1856,400,73,76,3
201884,2005,412,73,73,0
225948,1742,364,73,76,3
244950,1744,379,73,74,1
221909,1100,410,73,79,6
230358,1846,384,73,73,0
257889,1886,414,73,78,5
229221,1890,402,73,76,3
218981,1797,389,73,73,0
210021,1889,401,73,75,2
205157,1894,406,73,74,1
192612,1994,418,73,73,0
256612,1679,363,73,83,10
227939,1815,390,73,73,0
215651,1609,353,73,75,2
239970,1821,390,73,83,10
230242,1953,421,73,73,0
253537,1766,388,73,80,7
235888,1782,375,73,77,4
231777,1861,393,73,81,8
214369,1870,399,73,73,0
230432,1609,343,73,73,0
213536,1250,407,73,76,3
245535,2026,429,73,75,2
230175,1135,409,73,73,0
208159,1825,393,73,73,0
245278,1832,402,73,82,9
240926,1544,333,73,79,6
229406,1977,411,73,73,0
232805,1863,394,73,75,2
233061,1904,401,73,77,4
205670,1773,368,73,73,0
211302,1791,366,73,73,0
178287,1971,406,73,73,0
242287,1956,429,73,80,7
241775,1721,376,73,74,1
247150,1867,410,73,81,8
236142,1642,358,73,73,0
230254,1879,394,73,73,0
226414,1837,401,73,75,2
220782,1959,417,73,77,4
251756,1987,425,73,82,9
167532,1974,408,73,73,0
213868,1703,366,73,75,2
237419,1076,382,73,74,1
211818,1977,409,73,73,0
194665,1706,369,73,73,0
234857,1946,414,73,80,7
223593,1672,369,73,73,0
182888,1863,386,73,73,0
179560,1800,371,73,73,0
240744,1843,387,73,79,6
224103,1920,425,73,80,7
230246,1748,382,73,73,0
257821,1678,367,73,78,5
183581,1907,405,73,73,0
216605,1860,403,73,73,0
247827,1887,397,73,85,12
200469,1941,407,73,73,0
156437,1229,396,73,73,0
231445,1950,428,73,82,9
135190,1952,391,73,73,0
236822,1926,427,73,82,9
248854,1923,411,73,77,4
200984,1790,370,73,73,0
213272,1215,407,73,78,5
230424,1839,389,73,73,0
213017,1736,378,73,76,3
224537,1595,336,73,73,0
242969,1054,389,73,79,6
243993,1653,351,73,73,0
197402,1985,435,73,73,0
224538,1959,397,73,76,3
230170,1165,417,73,73,0
235290,1574,334,73,78,5
237595,1759,382,73,78,5
205340,1567,341,73,73,0
228124,1612,364,73,73,0
228892,1956,406,73,73,0
212244,1801,388,73,74,1
222227,1953,422,73,81,8
230408,1853,387,73,73,0
241937,1977,430,73,80,7
238856,1851,391,73,76,3
241928,1938,409,73,82,9
243976,1663,361,73,76,3
209673,1715,359,73,73,0
210441,1773,370,73,73,0
222729,1678,366,73,74,1
223241,2052,432,73,73,0
258826,1863,410,73,85,12
222475,1984,422,73,78,5
230411,1840,389,73,73,0
167435,1175,397,73,73,0
247819,1585,350,73,82,9
220172,1896,419,73,77,4
231436,1671,373,73,81,8
236556,2006,439,73,81,8
161805,1981,405,73,73,0
193549,1575,336,73,73,0
200463,1238,398,73,73,0
208144,1874,383,73,73,0
205073,1857,380,73,73,0
221969,1954,414,73,73,0
207984,2057,430,73,74,1
184176,1878,397,73,73,0
237525,1043,389,73,79,6
233670,2025,423,73,73,0
244426,1934,398,73,82,9
214986,1772,379,73,73,0
194761,1935,409,73,73,0
183497,1185,400,73,73,0
237000,1779,398,73,82,9
230344,1885,397,73,73,0
251847,1922,421,73,75,2
245703,1662,363,73,82,9
230855,1612,360,73,73,0
218311,1754,385,73,73,0
232646,1846,399,73,80,7
186992,2033,431,73,73,0
210374,1946,418,73,73,0
191173,1973,412,73,73,0
239045,1829,394,73,73,0
235973,1820,385,73,81,8
228805,1673,352,73,73,0
182212,1816,380,73,73,0
244675,1837,391,73,83,10
262595,1816,387,73,73,0
230850,1930,407,73,73,0
204738,1906,418,73,73,0
190666,1699,359,73,73,0
198348,1855,386,73,73,0
187084,1915,409,73,73,0
204493,1985,412,73,73,0
226517,1947,412,73,73,0
235036,1615,351,73,80,7
263893,1803,382,73,73,0
169426,1872,398,73,73,0
214226,1796,384,73,73,0
209618,1947,402,73,73,0
242641,1762,375,73,84,11
229585,1992,425,73,76,3
204497,1836,376,73,73,0
206544,1959,408,73,73,0
204240,1191,409,73,73,0
188879,1891,412,73,73,0
229071,1914,415,73,73,0
228815,1822,396,73,80,7
224718,1908,410,73,76,3
198350,1223,401,73,75,2
243661,1873,404,73,76,3
234701,1973,414,73,79,6
224461,1869,404,73,73,0
150477,1187,387,73,73,0
215245,1921,403,73,74,1
240064,1619,352,73,77,4
239808,2016,424,73,77,4
235456,1939,421,73,81,8
216067,1757,384,73,73,0
230147,1843,404,73,76,3
180739,1179,403,73,73,0
220932,1077,379,73,73,0
229636,1898,397,73,75,2
253444,1724,374,73,82,9
220165,1716,361,73,74,1
231685,1839,396,73,78,5
235781,1858,408,73,79,6
241925,1879,402,73,79,6
247045,1793,381,73,73,0
230918,1741,388,73,80,7
233478,1962,409,73,74,1
235526,1751,367,73,80,7
188166,1865,403,73,73,0
189446,1779,381,73,73,0
241159,1627,360,73,84,11
216072,1912,414,73,73,0
157960,2031,411,73,73,0
229128,1833,390,73,73,0
214129,1593,349,73,74,1
201073,1928,398,73,73,0
225539,1773,379,73,78,5
195586,1777,361,73,73,0
146111,1921,391,73,73,0
193794,1806,390,73,80,7
189303,1839,392,73,73,0
205943,1784,377,73,73,0
234870,1758,376,73,73,0
205942,1213,392,73,73,0
207733,1980,417,73,73,0
234100,1879,407,73,76,3
216692,1158,401,73,73,0
213620,1725,371,73,73,0
243315,1764,385,73,79,6
230259,1839,392,73,73,0
238194,1882,396,73,82,9
217714,1967,420,73,74,1
210802,1604,348,73,75,2
252017,1679,370,73,81,8
233585,1835,386,73,82,9
233984,1724,369,73,73,0
212225,1589,337,73,74,1
215553,1826,385,73,73,0
233218,1953,422,73,73,0
235522,1921,407,73,78,5
242434,1906,411,73,85,12
241856,1965,412,73,82,9
263288,1746,373,73,73,0
239744,1957,407,73,81,8
216464,2081,437,73,76,3
221584,1246,411,73,76,3
199313,1829,391,73,73,0
177553,2048,417,73,73,0
229010,2054,431,73,78,5
239356,1822,386,73,80,7
251132,1955,412,73,73,0
228349,1855,398,73,76,3
230397,1823,390,73,73,0
212478,1819,400,73,73,0
193336,1120,403,73,73,0
199737,1888,394,73,73,0
210489,1858,384,73,76,3
240953,1815,397,73,78,5
243001,2019,416,73,79,6
204346,1883,385,73,74,1
198715,1862,390,73,73,0
220475,1915,403,73,76,3
177723,1307,417,73,73,0
207676,1829,398,73,73,0
173857,1184,400,73,73,0
235663,1935,410,73,79,6
198200,1815,380,73,73,0
235407,1934,418,73,80,7
218936,1975,413,73,76,3
230456,1800,399,73,73,0
190520,1781,380,73,73,0
176009,1995,405,73,73,0
243593,1832,373,73,80,7
208522,1813,396,73,75,2
230282,1679,364,73,73,0
234122,1858,398,73,75,2
235658,1790,389,73,82,9
206219,1737,380,73,73,0
209547,1545,326,73,73,0
219787,1710,375,73,73,0
210828,1652,365,73,75,2
238988,1932,414,73,77,4
245132,1560,345,73,84,11
205965,1939,420,73,73,0
187533,1803,384,73,73,0
230286,1908,405,73,73,0
182670,1911,393,73,73,0
190780,1235,399,73,73,0
226877,1891,393,73,74,1
241981,1968,426,73,74,1
230462,1788,382,73,73,0
201285,1795,377,73,73,0
231493,1979,426,73,73,0
181573,2015,421,73,73,0
184133,2022,428,73,73,0
213063,1726,366,73,78,5
199559,1609,333,73,73,0
206152,1908,400,73,73,0
215368,1929,422,73,73,0
232008,1888,404,73,79,6
224841,1858,407,73,76,3
167753,1897,388,73,73,0
226378,1775,371,73,73,0
206411,1948,427,73,73,0
224075,2000,421,73,73,0
237131,1802,376,73,79,6
182859,1847,389,73,73,0
202316,2001,427,73,73,0
213581,1706,359,73,73,0
228173,1885,409,73,73,0
198213,1772,372,73,73,0
190276,1639,335,73,73,0
240452,1767,387,73,75,2
208449,1773,374,73,74,1
240190,2032,448,73,76,3
190782,1899,397,73,73,0
204863,1800,384,73,73,0
205119,1898,402,73,73,0
215871,1908,405,73,73,0
228415,1896,418,73,76,3
177983,1518,331,73,73,0
215616,1918,401,73,73,0
223297,1970,407,73,73,0
238660,1868,409,73,74,1
230209,1648,348,73,73,0
226370,1991,419,73,80,7
237122,1773,395,73,76,3
248386,1890,402,73,85,12
231235,1905,410,73,77,4
234819,1771,386,73,74,1
177475,1182,411,73,73,0
229188,1859,398,73,80,7
208440,1484,327,73,73,0
194359,1873,390,73,73,0
255565,1865,402,73,78,5
173178,1234,413,73,73,0
218746,1921,411,73,76,3
215930,1773,384,73,76,3
186745,1876,394,73,73,0
177273,1773,376,73,73,0
209529,1869,394,73,74,1
171896,1749,370,73,73,0
192647,1708,350,73,73,0
214408,1686,364,73,75,2
256136,1769,383,73,83,10
240265,1747,379,73,76,3
214462,1252,415,73,79,6
251681,1633,358,73,76,3
203042,1319,412,73,74,1
207650,1904,404,73,74,1
232226,1211,406,73,73,0
245538,1948,404,73,76,3
186146,1852,389,73,73,0
229667,1867,402,73,73,0
230435,1945,407,73,73,0
227706,1927,416,73,78,5
210556,1691,378,73,73,0
241463,1760,378,73,76,3
222844,1901,408,73,75,2
206469,2006,417,73,76,3
231044,2014,437,73,78,5
230276,1844,383,73,73,0
226436,1819,403,73,79,6
211844,2007,417,73,75,2
189059,1921,401,73,73,0
246914,1864,403,73,77,4
228738,1798,384,73,76,3
236935,1853,392,73,79,6
234112,1917,417,73,84,11
228736,1311,411,73,77,4
244863,1853,387,73,79,6
225151,1963,419,73,76,3
203903,1815,383,73,73,0
210814,1671,360,73,73,0
216701,1607,338,73,73,0
193148,1876,406,73,73,0
233084,1898,415,73,81,8
231292,1853,407,73,80,7
255523,1840,407,73,79,6
195363,1736,374,73,73,0
202276,1838,388,73,73,0
212772,1631,351,73,73,0
230445,1858,382,73,73,0
170797,1949,382,73,73,0
110381,1926,397,73,73,0
148526,1222,408,73,73,0
230446,1814,389,73,73,0
238126,1782,389,73,76,3
186158,1488,331,73,73,0
235055,1836,391,73,73,0
200752,1670,363,73,73,0
197937,1674,364,73,73,0
259377,1693,358,73,84,11
229682,1586,352,73,80,7
247090,1987,422,73,84,11
229683,1729,362,73,73,0
207924,1990,415,73,73,0
237109,1828,397,73,73,0
205878,1207,400,73,76,3
207926,1138,408,73,76,3
187702,1956,416,73,73,0
226861,1786,388,73,74,1
224301,1761,376,73,78,5
205869,1805,376,73,73,0
220969,1771,383,73,75,2
215076,2011,423,73,73,0
215332,1992,429,73,73,0
230436,1754,374,73,73,0
186148,1165,404,73,73,0
191269,1984,407,73,73,0
213798,2010,407,73,75,2
233767,1811,392,73,78,5
224808,1448,321,73,74,1
190761,1994,418,73,73,0
236076,1900,411,73,73,0
155946,1950,402,73,73,0
258602,1853,392,73,79,6
212267,1899,408,73,73,0
236075,2004,420,73,73,0
236331,1610,346,73,78,5
226604,1900,410,73,76,3
227884,1691,391,73,79,6
233260,1854,404,73,81,8
236109,1740,373,73,73,0
230215,1714,372,73,73,0
191053,1997,417,73,73,0
180818,1854,385,73,73,0
199763,1903,413,73,73,0
204883,1203,418,73,76,3
210259,1748,362,73,73,0
228179,2010,427,73,73,0
190547,1470,315,73,73,0
195412,2018,430,73,73,0
223573,1264,403,73,73,0
190549,1972,420,73,73,0
246870,1889,403,73,78,5
258390,1022,385,73,79,6
224599,1243,405,73,73,0
230487,1890,384,73,73,0
210520,1839,400,73,74,1
230488,1835,383,73,73,0
239704,1836,395,73,76,3
201049,1574,332,73,73,0
204121,1826,397,73,73,0
210010,1900,403,73,74,1
228698,1996,422,73,76,3
190034,1794,382,73,74,1
230482,1805,371,73,73,0
237223,1955,418,73,73,0
228946,1923,423,73,80,7
225359,1886,388,73,73,0
234575,1582,347,73,81,8
178255,1822,394,73,73,0
191055,1875,405,73,73,0
207440,1840,390,73,73,0
207952,1674,383,73,74,1
214096,1690,369,73,76,3
219728,1883,405,73,73,0
158800,1881,377,73,73,0
235088,1799,394,73,76,3
236624,1887,412,73,79,6
242000,1582,359,73,82,9
232270,1888,414,73,80,7
223313,1977,417,73,73,0
226129,1701,370,73,77,4
163665,1613,343,73,73,0
234577,1071,390,73,85,12
247377,1839,403,73,85,12
204370,1969,407,73,73,0
179546,1793,361,73,73,0
245850,2004,422,73,73,0
194138,1820,388,73,73,0
202331,1942,413,73,73,0
236537,1859,403,73,80,7
162297,1043,397,73,73,0
182520,1208,405,73,73,0
208120,1725,371,73,73,0
190199,1998,417,73,73,0
183287,1892,378,73,73,0
244727,1683,365,73,73,0
218359,1959,416,73,74,1
176630,1462,417,73,73,0
213750,1921,418,73,73,0
212214,1981,426,73,73,0
234741,2041,424,73,80,7
232437,1820,394,73,75,2
217845,1993,423,73,75,2
183540,1954,388,73,73,0
248820,1811,394,73,81,8
150516,1932,395,73,73,0
193011,1627,341,73,73,0
201971,1895,395,73,73,0
225018,1915,400,73,73,0
193786,1144,405,73,73,0
208892,1897,407,73,73,0
193886,1946,399,73,73,0
246875,1656,381,73,84,11
215132,1292,409,73,73,0
239452,1821,389,73,80,7
230493,1718,371,73,73,0
185181,1209,396,73,73,0
214622,1767,392,73,74,1
245598,1756,386,73,79,6
192350,1943,408,73,73,0
214111,1861,405,73,73,0
212476,1919,388,73,74,1
164959,1940,406,73,73,0
209504,1772,377,73,73,0
239712,1760,368,73,76,3
233982,1921,397,73,73,0
201215,2012,410,73,73,0
206591,1991,416,73,73,0
229631,1751,387,73,76,3
238332,1934,418,73,76,3
220414,1952,412,73,73,0
246352,1747,368,73,82,9
208052,1871,409,73,73,0
206518,1771,385,73,76,3
224949,1722,384,73,79,6
159413,1895,405,73,73,0
194996,1720,360,73,73,0
257204,1757,375,73,81,8
229556,1817,401,73,74,1
225204,1973,421,73,80,7
251570,1712,370,73,88,15
233138,1815,381,73,73,0
230578,1648,356,73,79,6
199602,1841,378,73,73,0
239025,1669,363,73,81,8
207537,1996,434,73,73,0
225200,1723,378,73,79,6
201136,1821,385,73,73,0
227503,1931,418,73,80,7
189358,1807,364,73,73,0
252590,1744,372,73,83,10
215725,1889,397,73,78,5
162220,1238,407,73,73,0
206006,2046,430,73,73,0
208054,1918,408,73,73,0
224428,1869,406,73,74,1
208822,1915,403,73,73,0
252238,1880,396,73,85,12
192445,1721,368,73,73,0
230333,1749,375,73,73,0
221885,1889,408,73,75,2
255420,1713,375,73,76,3
166074,1933,425,73,73,0
201145,1838,378,73,73,0
237496,1926,412,73,77,4
231864,1724,375,73,79,6
166072,1550,322,73,73,0
214968,1901,400,73,73,0
234935,1768,383,73,73,0
231095,1910,405,73,73,0
216247,1941,412,73,73,0
252086,1903,408,73,74,1
223926,2040,432,73,78,5
220854,1950,414,73,76,3
212150,1964,403,73,76,3
210358,1140,397,73,74,1
225964,1870,386,73,80,7
233606,1839,396,73,79,6
199852,1842,392,73,73,0
190633,1868,406,73,73,0
242087,1863,411,73,76,3
244391,1826,394,73,78,5
252327,1721,378,73,83,10
182184,1913,390,73,73,0
190120,1271,412,73,73,0
235176,1916,405,73,73,0
221354,1610,340,73,76,3
221610,985,382,73,73,0
194730,1307,423,73,73,0
205995,1995,425,73,73,0
214955,1967,418,73,73,0
152747,1845,390,73,73,0
226697,1844,405,72,75,3
256903,1851,401,72,86,14
211592,1640,356,72,72,0
158856,1929,391,72,72,0
189576,1690,363,72,74,2
210313,1886,396,72,75,3
202135,2041,427,72,72,0
212618,1772,371,72,72,0
212107,1674,362,72,72,0
230283,1759,360,72,72,0
203751,1812,387,72,72,0
201447,1925,416,72,72,0
234119,1918,403,72,79,7
241031,1617,353,72,79,7
223877,1761,379,72,77,5
228231,1227,403,72,72,0
252038,1833,389,72,82,10
189061,1106,401,72,72,0
230277,1719,375,72,72,0
225669,1870,417,72,75,3
237973,1813,394,72,79,7
201093,1922,395,72,73,1
225668,1817,391,72,78,6
212100,1811,396,72,79,7
208260,1829,400,72,74,2
194947,1605,333,72,72,0
178051,1774,378,72,72,0
217731,1829,373,72,75,3
177896,1903,394,72,72,0
201878,1840,383,72,72,0
245138,1921,405,72,82,10
214421,1885,404,72,72,0
208277,1879,402,72,72,0
198019,1808,376,72,72,0
251532,1809,396,72,77,5
255371,1703,375,72,84,12
243851,1786,386,72,72,0
242571,1863,402,72,75,3
239755,1790,378,72,73,1
215437,1647,368,72,73,1
172685,1774,382,72,72,0
206222,1802,382,72,72,0
213134,1915,406,72,73,1
217998,1778,382,72,73,1
247182,1758,380,72,81,9
210831,2013,409,72,75,3
220815,1915,413,72,75,3
199568,1205,402,72,72,0
210320,1830,387,72,73,1
220048,1250,400,72,75,3
234640,1798,404,72,76,4
219793,1183,410,72,76,4
230289,1946,401,72,72,0
240017,1827,394,72,81,9
246929,1830,411,72,73,1
229266,1533,338,72,81,9
177299,1169,398,72,72,0
255891,1632,362,72,79,7
199060,1837,384,72,72,0
244628,1802,390,72,74,2
258946,1585,351,72,81,9
199897,1805,384,72,72,0
230530,1907,400,72,72,0
228813,1892,394,72,76,4
190919,1921,388,72,72,0
246728,1746,378,72,82,10
204233,1624,350,72,75,3
210377,1755,371,72,72,0
229321,1790,389,72,72,0
235210,2014,412,72,72,0
222411,1235,407,72,75,3
236492,1984,420,72,80,8
247500,1694,380,72,78,6
251852,1851,394,72,86,14
189388,1773,392,72,72,0
217805,1233,405,72,74,2
193485,1807,367,72,72,0
190593,1981,411,72,72,0
230350,1789,385,72,72,0
208335,1740,376,72,72,0
213711,1953,420,72,72,0
232655,1941,423,72,72,0
204496,1568,324,72,74,2
242384,1663,360,72,72,0
227537,1591,359,72,72,0
233169,1855,405,72,72,0
199890,1944,414,72,72,0
210386,1863,393,72,73,1
232658,1677,366,72,79,7
187858,1932,404,72,72,0
241607,1952,419,72,81,9
219637,1292,416,72,77,5
230389,1696,359,72,72,0
232693,1610,359,72,79,7
169214,1854,396,72,72,0
204542,2031,420,72,72,0
204030,1918,412,72,72,0
199422,1923,394,72,72,0
193277,1257,405,72,72,0
248573,1944,428,72,80,8
242429,1952,421,72,83,11
228861,1711,378,72,72,0
224508,1814,386,72,72,0
222204,1847,389,72,72,0
190971,1931,401,72,72,0
224763,1771,382,72,80,8
199419,1840,385,72,72,0
223994,1684,356,72,72,0
189945,1861,390,72,72,0
239097,1699,366,72,72,0
222457,1966,424,72,75,3
244472,1931,423,72,82,10
229624,1793,384,72,72,0
221944,1984,412,72,74,2
201208,1681,365,72,73,1
251127,1872,410,72,72,0
245238,1572,339,72,81,9
231414,1866,399,72,73,1
214006,1976,415,72,72,0
198355,1221,400,72,72,0
216019,1731,363,72,72,0
216275,1756,379,72,72,0
240095,1942,405,72,75,3
204513,1101,396,72,74,2
214497,1891,403,72,72,0
230369,1971,423,72,72,0
251873,1698,363,72,85,13
215010,1815,399,72,72,0
217826,1944,423,72,75,3
231138,1873,400,72,73,1
180706,1556,324,72,72,0
263139,930,380,72,80,8
229091,1250,411,72,79,7
232163,1784,389,72,72,0
236259,1902,401,72,75,3
184035,1836,404,72,72,0
213732,1208,401,72,74,2
231652,1669,361,72,75,3
237540,1874,412,72,73,1
240100,1773,377,72,73,1
194020,1943,414,72,72,0
223717,1952,417,72,77,5
236773,1850,400,72,75,3
239845,1975,431,72,78,6
189157,1834,395,72,72,0
223206,1775,381,72,72,0
227558,1736,369,72,76,4
230374,1902,401,72,72,0
199904,1138,397,72,72,0
230367,1788,386,72,72,0
221908,1870,407,72,76,4
155871,1158,393,72,72,0
224980,1821,405,72,73,1
226772,1670,363,72,72,0
192725,1755,378,72,72,0
183254,1737,352,72,72,0
211927,1885,391,72,72,0
200408,1528,323,72,73,1
211672,1773,377,72,73,1
215018,2011,424,72,72,0
213209,2033,428,72,77,5
234457,2082,438,72,76,4
236505,1552,332,72,75,3
245209,1970,413,72,77,5
244186,1756,378,72,77,5
250842,1059,379,72,78,6
260314,1565,354,72,76,4
199387,1869,392,72,72,0
240091,1005,384,72,78,6
226012,1912,402,72,76,4
236764,1951,414,72,78,6
258781,1647,352,72,82,10
194781,1152,403,72,72,0
227550,1426,304,72,72,0
183774,1367,288,72,72,0
253150,1750,371,72,80,8
258782,1597,350,72,76,4
245992,1846,387,72,86,14
204387,1832,388,72,72,0
163050,1772,362,72,72,0
256958,1765,376,72,85,13
224438,1721,371,72,76,4
178614,1748,372,72,72,0
223159,1635,357,72,77,5
232120,1889,415,72,76,4
211385,1958,412,72,72,0
230329,1755,372,72,72,0
221370,1916,406,72,72,0
230074,1727,369,72,75,3
226747,1796,387,72,72,0
188091,1881,405,72,72,0
205756,1831,384,72,74,2
214973,1798,373,72,72,0
251325,1701,379,72,75,3
239550,1621,353,72,77,5
213439,1914,403,72,72,0
197813,1934,400,72,72,0
214207,1924,407,72,72,0
233151,1908,394,72,77,5
221120,1913,404,72,74,2
242112,1787,388,72,73,1
196801,1694,353,72,72,0
206529,1685,365,72,72,0
143809,1901,390,72,72,0
213697,1927,406,72,77,5
221890,1823,397,72,74,2
223682,2016,412,72,72,0
228290,1527,325,72,74,2
228802,1803,393,72,72,0
231874,1698,375,72,76,4
238274,1864,399,72,80,8
193461,1944,411,72,72,0
214196,1946,405,72,72,0
233924,1777,384,72,78,6
216749,1862,387,72,72,0
216682,1844,388,72,72,0
219754,1209,393,72,74,2
164459,2025,403,72,72,0
191083,1698,358,72,72,0
228716,1806,387,72,72,0
239212,1869,392,72,72,0
241004,1928,411,72,77,5
183916,1970,406,72,72,0
228717,1847,390,72,72,0
240493,1204,405,72,72,0
179565,1809,366,72,72,0
205934,1741,378,72,74,2
238507,1766,385,72,76,4
200108,1869,391,72,72,0
184749,1923,394,72,72,0
236723,1882,412,72,76,4
230319,1121,380,72,72,0
125871,1873,401,72,72,0
225456,1758,367,72,73,1
231344,1759,387,72,76,4
231856,1927,407,72,77,5
190640,1884,409,72,72,0
231089,1806,391,72,78,6
236721,1890,403,72,78,6
262578,1458,324,72,85,13
213938,1651,349,72,74,2
230322,1857,399,72,72,0
232882,1819,398,72,76,4
211891,1898,404,72,72,0
219571,1999,415,72,73,1
183491,1654,352,72,72,0
178628,1915,402,72,72,0
199274,1785,373,72,72,0
220785,1730,375,72,72,0
182133,1655,347,72,72,0
224885,1892,407,72,72,0
230260,1726,366,72,72,0
222836,1890,396,72,77,5
209780,1952,400,72,76,4
189043,1984,402,72,72,0
233075,1625,347,72,72,0
226419,1787,373,72,72,0
199027,1772,377,72,73,1
241522,1840,393,72,79,7
211826,1733,374,72,72,0
142962,1212,397,72,72,0
233841,1640,364,72,80,8
233329,1715,375,72,74,2
215665,1874,394,72,72,0
232310,1657,356,72,73,1
204401,1910,398,72,72,0
203889,1773,370,72,72,0
224368,1826,391,72,72,0
220528,1888,394,72,77,5
194415,1679,365,72,72,0
251503,976,378,72,72,0
248687,1482,328,72,82,10
216175,1156,388,72,74,2
213871,1739,382,72,73,1
197231,1739,365,72,72,0
192622,1601,335,72,72,0
188270,1579,335,72,72,0
186990,1219,389,72,72,0
230510,1777,372,72,72,0
192373,1696,350,72,72,0
230519,1849,378,72,72,0
246469,1725,380,72,83,11
225149,1218,404,72,76,4
225478,1894,404,72,72,0
198599,1881,412,72,72,0
214983,1112,391,72,72,0
224967,1815,390,72,73,1
250753,1093,390,72,78,6
246145,1765,387,72,82,10
241025,1765,380,72,75,3
231041,1822,397,72,72,0
230272,1879,401,72,72,0
212607,1662,348,72,72,0
206463,1997,417,72,75,3
187517,1700,357,72,72,0
252541,1886,401,72,80,8
230525,1121,393,72,72,0
221564,1813,381,72,78,6
184183,1521,324,72,72,0
258683,1879,407,72,82,10
230267,1808,376,72,72,0
202107,1898,398,72,72,0
134779,1879,387,72,72,0
253306,1792,401,72,84,12
245370,946,385,72,80,8
215162,1701,349,72,72,0
213114,1919,402,72,72,0
189561,1659,369,72,72,0
188537,1892,418,72,72,0
223097,1953,413,72,75,3
202873,1136,397,72,72,0
203128,1892,393,72,72,0
199288,1854,390,72,72,0
207722,1945,417,72,72,0
237161,1861,389,72,79,7
238058,1951,416,72,79,7
215565,1507,331,72,75,3
200713,1987,410,72,72,0
230665,1927,409,72,72,0
233225,1738,373,72,72,0
233993,1781,377,72,72,0
172553,1146,387,72,72,0
149258,950,372,72,72,0
215050,1664,362,72,72,0
233994,1589,352,72,72,0
171018,1855,382,72,72,0
204555,1965,408,72,72,0
222987,1975,423,72,72,0
233483,1801,381,72,72,0
223756,1968,416,72,77,5
246284,1843,394,72,81,9
224013,1900,404,72,76,4
252168,1633,358,72,76,4
239373,1958,419,72,78,6
206606,1612,351,72,72,0
216334,1996,403,72,74,2
222734,1913,412,72,73,1
230414,1701,375,72,72,0
199183,2008,421,72,72,0
199439,1830,387,72,72,0
223247,1973,410,72,72,0
224271,1822,395,72,72,0
194063,1963,415,72,72,0
203024,1888,383,72,72,0
230672,1585,352,72,80,8
237840,1912,406,72,79,7
251408,1707,356,72,72,0
199689,1903,400,72,72,0
228616,1220,405,72,77,5
209937,1870,400,72,72,0
198128,1853,387,72,72,0
204523,1881,385,72,72,0
176619,1860,386,72,72,0
257771,1883,410,72,75,3
200429,1895,393,72,75,3
212205,1769,377,72,73,1
226285,1185,396,72,74,2
226797,1983,418,72,72,0
244973,1879,398,72,82,10
252909,1906,415,72,78,6
204526,1937,406,72,72,0
226798,1847,394,72,72,0
205551,1988,418,72,72,0
155887,1868,388,72,72,0
192495,1873,403,72,72,0
183280,1620,352,72,72,0
230407,1726,361,72,72,0
189680,1954,408,72,72,0
233201,1666,359,72,80,8
247793,1951,417,72,79,7
192241,1966,420,72,72,0
202994,1945,419,72,72,0
212722,1916,413,72,72,0
239090,1821,388,72,74,2
214515,1966,415,72,72,0
228595,1905,413,72,74,2
199412,1932,419,72,72,0
224756,1972,417,72,76,4
181236,1912,400,72,72,0
201223,1977,424,72,72,0
223495,1796,386,72,73,1
205585,1859,376,72,72,0
215569,1670,361,72,73,1
236393,1702,367,72,74,2
199779,1608,346,72,73,1
230495,1702,350,72,72,0
179551,1825,385,72,72,0
198240,1953,403,72,72,0
223072,1896,398,72,72,0
244832,1712,362,72,80,8
254048,1943,415,72,76,4
212321,1794,380,72,73,1
238945,1561,337,72,74,2
240225,1039,393,72,82,10
221282,1864,404,72,77,5
232546,1841,393,72,72,0
233314,1836,393,72,75,3
176994,1105,395,72,72,0
242530,1791,402,72,81,9
239358,1102,392,72,75,3
259166,996,382,72,81,9
244068,1539,342,72,76,4
199781,1780,384,72,72,0
210533,1904,393,72,72,0
221797,1793,375,72,72,0
230501,1850,384,72,72,0
234341,1035,397,72,80,8
226662,1813,393,72,75,3
192102,1927,407,72,72,0
213095,1766,384,72,72,0
230503,1726,355,72,72,0
202088,1817,389,72,72,0
215144,1838,405,72,72,0
224104,1932,416,72,72,0
182632,2038,422,72,72,0
229215,1875,394,72,72,0
245597,1865,397,72,82,10
210450,1670,366,72,73,1
189462,1854,390,72,72,0
234514,1826,396,72,72,0
251410,1891,417,72,73,1
190738,1868,404,72,72,0
219411,1771,377,72,72,0
225555,1993,421,72,72,0
234515,1664,360,72,72,0
200212,1204,395,72,72,0
203796,1945,403,72,72,0
217620,1710,389,72,73,1
230420,1880,389,72,72,0
240916,1899,409,72,78,6
186132,1933,397,72,72,0
243989,1847,395,72,72,0
215062,1790,377,72,72,0
239127,1865,410,72,77,5
241501,1706,366,72,72,0
231448,1754,380,72,81,9
205081,1863,401,72,72,0
207897,1936,414,72,72,0
230681,1818,403,72,77,5
199000,1806,383,72,72,0
207960,1853,394,72,72,0
205401,1774,388,72,72,0
222553,1743,383,72,72,0
201818,1789,380,72,72,0
253274,1724,379,72,72,0
206171,1870,409,72,72,0
234843,1717,386,72,78,6
193884,1973,420,72,72,0
238941,1876,396,72,73,1
237566,1989,428,72,73,1
211626,1933,399,72,72,0
241406,1893,404,72,77,5
168354,1186,394,72,72,0
204193,1831,378,72,73,1
205985,1757,375,72,72,0
229793,1645,371,72,77,5
193185,1892,407,72,72,0
201122,1733,384,72,73,1
223138,1725,361,72,74,2
234914,1932,406,72,77,5
221600,1659,359,72,76,4
240034,1633,368,72,72,0
187298,1677,356,72,72,0
193186,1223,399,72,72,0
187043,1986,415,72,72,0
221860,1793,376,72,75,3
223652,1894,406,72,74,2
223136,1990,423,72,72,0
241823,1810,381,72,78,6
231588,1668,369,72,78,6
215965,1661,375,72,75,3
211354,1970,408,72,73,1
205212,1824,380,72,72,0
207516,1712,362,72,72,0
233372,1838,388,72,73,1
181404,1606,344,72,72,0
192156,1927,405,72,72,0
176285,1555,319,72,72,0
205215,1589,334,72,72,0
253341,1621,349,72,73,1
205726,1917,396,72,72,0
231070,1955,404,72,72,0
189342,1118,394,72,72,0
200607,1634,347,72,72,0
201887,1946,410,72,72,0
230564,1955,409,72,74,2
216229,1905,397,72,72,0
209485,1890,397,72,72,0
234570,1809,374,72,83,11
216391,1764,374,72,73,1
190535,1806,368,72,72,0
231240,1753,373,72,78,6
233800,1803,399,72,78,6
228681,1500,331,72,78,6
230218,1639,340,72,72,0
237642,1777,391,72,79,7
243014,1907,399,72,80,8
240970,1906,405,72,81,9
208459,1747,385,72,72,0
228171,1886,407,72,73,1
192587,2027,420,72,72,0
199244,1633,356,72,72,0
228684,1725,386,72,80,8
211527,1847,391,72,72,0
234054,1030,380,72,72,0
152997,1810,367,72,72,0
240963,1742,377,72,72,0
229541,1202,398,72,77,5
212035,1893,399,72,72,0
220739,1807,371,72,73,1
156483,1328,402,72,72,0
228419,1533,325,72,78,6
229699,1774,390,72,79,7
189508,1776,359,72,72,0
222022,1923,420,72,73,1
193860,1968,413,72,72,0
213573,1215,389,72,74,2
187205,1918,402,72,72,0
196934,1980,404,72,72,0
206662,1547,330,72,72,0
209990,1090,386,72,74,2
197786,1818,385,72,72,0
261529,1902,407,72,77,5
244377,1469,317,72,81,9
241976,1167,398,72,77,5
193337,2072,441,72,72,0
223033,1662,361,72,77,5
222521,1508,325,72,72,0
221753,1845,402,72,73,1
185144,1655,343,72,72,0
244280,1826,388,72,79,7
238392,1846,397,72,77,5
235834,1851,395,72,77,5
207928,1873,404,72,72,0
197688,1929,403,72,72,0
193847,1846,384,72,72,0
258615,1903,416,72,81,9
186935,1941,399,72,72,0
251191,1730,372,72,73,1
198970,1705,370,72,72,0
229179,1818,396,72,72,0
235161,1701,368,72,78,6
211009,1741,374,72,75,3
258370,1799,402,72,82,10
245058,1963,410,72,76,4
232514,1901,393,72,72,0
230466,1781,349,72,72,0
221250,1835,394,72,72,0
240193,1870,397,72,76,4
230464,1757,361,72,72,0
229435,1846,382,72,76,4
199231,1936,421,72,72,0
230718,1614,363,72,72,0
192317,1182,405,72,73,1
230461,1810,376,72,72,0
179516,1858,377,72,72,0
204092,1218,397,72,73,1
239671,1863,406,72,78,6
228151,1905,401,72,75,3
213815,1728,386,72,74,2
221488,1936,405,72,72,0
183346,1969,410,72,72,0
242737,1831,392,72,72,0
227633,1899,410,72,75,3
215089,1884,396,72,72,0
199729,1963,417,72,72,0
193584,1826,385,72,72,0
204334,1094,394,72,72,0
212023,1803,371,72,72,0
215703,1747,376,72,77,5
244376,1756,388,72,77,5
198553,1946,407,72,72,0
214937,1908,411,72,73,1
223641,1582,348,72,76,4
228505,1273,411,72,80,8
184626,1779,360,72,72,0
196916,1915,395,72,72,0
215604,1811,397,72,72,0
223284,1826,386,72,72,0
226356,1943,415,72,75,3
230452,1830,391,72,72,0
230708,1490,325,72,78,6
193844,1923,397,72,72,0
205365,1818,383,72,72,0
213813,1958,413,72,73,1
165429,1904,393,72,72,0
231733,1804,381,72,75,3
192565,1820,370,72,72,0
213302,1804,381,72,72,0
223231,1933,401,72,72,0
242998,1772,385,72,77,5
198455,1996,421,72,72,0
230988,1913,401,72,74,2
245062,1751,379,72,72,0
212045,2016,427,72,74,2
230441,1789,393,72,72,0
212226,1971,404,72,72,0
257025,1646,357,72,82,10
236033,1121,402,72,80,8
198145,1794,375,72,72,0
169216,1831,387,72,72,0
230477,1824,401,72,72,0
241708,1582,350,72,81,9
230188,1828,396,72,72,0
228908,1983,403,72,72,0
221740,1794,383,72,74,2
190507,1555,328,72,72,0
212778,1750,374,72,72,0
200746,1901,408,72,73,1
230185,1239,402,72,72,0
239106,1913,404,72,74,2
223017,2030,423,72,72,0
210985,1909,405,72,73,1
220968,1916,418,72,75,3
219688,1619,351,72,72,0
234791,1698,374,72,75,3
215079,1988,410,72,72,0
193062,1950,420,72,72,0
226086,1817,403,72,72,0
186405,1862,396,72,72,0
242725,1938,420,72,79,7
230181,1874,392,72,72,0
228645,1951,411,72,73,1
195620,1991,426,72,72,0
233730,1910,407,72,76,4
239875,1837,384,72,72,0
237604,1643,363,72,79,7
236038,1803,403,72,78,6
253695,1737,383,72,76,4
206506,1934,407,72,72,0
239272,1154,393,72,75,3
235432,1757,386,72,78,6
246183,1887,406,72,77,5
226215,1851,393,72,72,0
209063,1582,338,72,72,0
203431,1892,409,72,72,0
202151,1958,411,72,72,0
229542,1038,389,72,74,2
223654,1875,394,72,78,6
205478,1710,371,72,72,0
246790,1784,387,72,72,0
228614,1801,408,72,73,1
251139,2002,429,72,72,0
222982,1813,372,72,74,2
212230,1821,370,72,72,0
206086,1844,392,72,75,3
194053,1528,323,72,72,0
245253,1890,397,72,80,8
229637,1179,406,72,73,1
217605,1897,401,72,72,0
216325,1238,404,72,76,4
211461,1775,364,72,72,0
206085,1912,412,72,73,1
258308,1540,341,72,78,6
207876,1988,426,72,72,0
186115,1929,409,72,72,0
253220,1884,406,72,72,0
222464,1275,411,72,78,6
235812,1724,372,72,72,0
230483,1793,374,72,72,0
192537,1853,379,72,72,0
184089,1789,366,72,72,0
232729,1853,400,72,72,0
232869,1689,379,72,73,1
196952,1833,386,72,72,0
195671,1722,353,72,72,0
251990,1755,366,72,82,10
241750,1786,377,72,73,1
213846,1771,376,72,72,0
254548,1839,401,72,82,10
253012,1335,409,72,85,13
185172,1090,390,72,72,0
139860,1754,355,72,72,0
143699,1983,415,72,72,0
205594,1954,417,72,72,0
201043,2028,422,72,72,0
222546,1057,396,72,73,1
183632,1971,403,72,72,0
246608,1885,403,72,78,6
234832,1682,378,72,73,1
219984,1871,394,72,73,1
234319,1878,406,72,80,8
256035,1761,386,72,84,12
246606,1813,397,72,83,11
239950,1907,402,72,77,5
230222,1859,392,72,72,0
225614,1838,397,72,78,6
213582,1828,377,72,72,0
258585,1006,387,72,79,7
193870,1173,398,72,72,0
213530,1810,386,72,72,0
256287,1842,397,72,84,12
229155,1903,406,72,76,4
229658,1841,402,72,72,0
215331,1844,397,72,72,0
230434,1878,397,72,72,0
244257,1802,394,72,82,10
235553,1477,320,72,73,1
235297,2038,436,72,75,3
232225,1626,360,72,77,5
230433,1674,358,72,72,0
205601,1772,366,72,72,0
239136,1766,385,72,80,8
230176,1191,405,72,72,0
219680,1508,326,72,74,2
233250,1843,389,72,76,4
234015,1754,362,72,72,0
232477,1914,414,72,73,1
251675,1975,422,72,76,4
172316,1933,399,72,72,0
189468,1953,416,72,72,0
230429,1728,367,72,72,0
230685,1935,401,72,72,0
186140,1724,364,72,72,0
239645,1813,381,72,73,1
204830,1799,383,72,72,0
214302,1960,415,72,75,3
216351,1965,408,72,72,0
219167,1849,384,72,72,0
229148,1880,412,71,71,0
236316,1822,396,71,79,8
198429,1845,394,71,71,0
207645,1789,384,71,71,0
245021,1748,372,71,80,9
215070,1626,349,71,72,1
220702,1888,401,71,74,3
221982,1663,353,71,76,5
229150,1801,394,71,77,6
236830,1896,403,71,77,6
258846,1774,369,71,80,9
237055,1669,366,71,74,3
194334,1627,355,71,71,0
209695,1877,399,71,72,1
240671,1624,357,71,79,8
208160,1897,396,71,71,0
262908,1548,340,71,77,6
236287,1747,371,71,72,1
231423,1920,405,71,76,5
182270,1181,407,71,71,0
190461,1867,396,71,71,0
251901,1613,367,71,76,5
220925,1954,410,71,72,1
182043,1160,383,71,71,0
216860,1672,364,71,75,4
213777,1941,411,71,75,4
251673,1021,379,71,71,0
176920,1769,373,71,71,0
188154,1962,399,71,71,0
229654,1778,403,71,71,0
183573,1875,392,71,71,0
240661,1737,367,71,82,11
223765,1821,389,71,74,3
211221,1841,401,71,71,0
258580,1687,365,71,76,5
252692,1687,366,71,76,5
243988,1774,377,71,76,5
198420,1827,397,71,71,0
241171,1731,379,71,79,8
202515,1788,378,71,71,0
203537,1727,382,71,71,0
229648,1746,373,71,76,5
212240,1718,372,71,72,1
195087,1666,361,71,71,0
248831,1539,335,71,78,7
199191,1773,380,71,71,0
223255,1887,399,71,76,5
223511,1804,382,71,71,0
226583,1667,370,71,71,0
201240,1825,399,71,71,0
228120,1925,411,71,77,6
226811,1780,379,71,72,1
208700,1797,386,71,71,0
183546,1821,392,71,71,0
179687,1914,410,71,71,0
243945,1741,369,71,71,0
239593,1784,372,71,71,0
231913,1989,419,71,75,4
220649,1780,386,71,71,0
244456,1507,330,71,75,4
204776,1609,343,71,71,0
248295,1566,344,71,71,0
181479,1648,335,71,71,0
234727,1675,374,71,75,4
143587,1964,394,71,71,0
215015,1593,350,71,71,0
186598,1810,389,71,71,0
248550,1669,361,71,80,9
228838,1788,380,71,74,3
212197,1125,395,71,71,0
242916,1836,393,71,79,8
212196,1884,391,71,72,1
244963,1491,336,71,76,5
190697,1687,366,71,71,0
227562,1816,382,71,74,3
221931,1937,400,71,71,0
227819,1204,398,71,75,4
213746,1764,383,71,71,0
193264,1924,416,71,71,0
252144,1509,329,71,83,12
229360,1614,330,71,74,3
229104,1889,390,71,71,0
221168,1758,377,71,76,5
236015,1858,395,71,81,10
205295,1899,402,71,71,0
226286,1648,362,71,71,0
216302,1862,385,71,71,0
143598,1044,372,71,71,0
245741,1798,390,71,84,13
241389,1717,357,71,78,7
223212,1786,387,71,73,2
202220,1823,390,71,71,0
237291,1685,368,71,71,0
234731,1554,337,71,71,0
240099,1854,408,71,80,9
206307,1105,394,71,73,2
242162,1851,400,71,81,10
177922,1856,387,71,71,0
203782,1871,396,71,71,0
197382,1649,351,71,71,0
204549,1216,400,71,73,2
202501,1820,380,71,72,1
219652,1851,387,71,71,0
215556,1885,410,71,75,4
241923,1790,384,71,76,5
222467,1899,397,71,72,1
233986,1763,369,71,71,0
184290,1633,342,71,71,0
199170,1990,419,71,71,0
197890,1649,368,71,71,0
186881,1962,413,71,71,0
250881,1806,396,71,76,5
239617,1770,375,71,78,7
239361,1948,412,71,77,6
223489,1809,386,71,71,0
191488,1849,384,71,71,0
210950,1994,401,71,71,0
254470,1788,383,71,81,10
203783,1790,386,71,71,0
239367,1714,374,71,80,9
244706,1703,363,71,71,0
223458,1841,403,71,71,0
251105,1775,377,71,79,8
226273,1937,410,71,71,0
230368,1805,388,71,71,0
220128,1809,381,71,71,0
212192,1793,377,71,72,1
200672,1879,412,71,71,0
196318,1790,384,71,71,0
190430,1821,384,71,71,0
245214,1761,392,71,71,0
233231,1706,359,71,74,3
222986,1877,387,71,71,0
225289,1803,379,71,76,5
257288,1081,372,71,81,10
219912,1797,382,71,71,0
200968,1515,313,71,71,0
224242,1898,411,71,73,2
205812,1115,388,71,71,0
247802,1767,372,71,72,1
243526,1783,397,71,80,9
198474,1721,372,71,71,0
229705,1690,366,71,76,5
190536,1959,400,71,71,0
243016,1796,387,71,81,10
224584,1702,365,71,71,0
182343,1986,414,71,71,0
207431,1540,325,71,73,2
196935,1534,344,71,72,1
230470,1863,396,71,71,0
230211,1722,382,71,71,0
223302,1763,376,71,74,3
211014,1845,395,71,71,0
203590,1532,328,71,71,0
190021,1958,408,71,71,0
232517,1649,352,71,71,0
231749,1828,393,71,75,4
245572,1738,382,71,76,5
199236,1932,411,71,71,0
199157,1888,407,71,71,0
199413,1925,398,71,71,0
199669,1827,394,71,71,0
167669,1793,355,71,71,0
235002,1473,318,71,73,2
229882,1980,421,71,74,3
212474,1957,405,71,71,0
200698,1179,395,71,71,0
253177,1837,413,71,82,11
233977,999,391,71,71,0
232441,1060,387,71,71,0
222969,1739,370,71,71,0
220921,1671,369,71,73,2
220665,1559,341,71,75,4
213497,1696,361,71,74,3
238072,1887,405,71,76,5
198136,1837,394,71,71,0
255223,1764,382,71,83,12
234999,1084,391,71,75,4
233974,1001,362,71,71,0
230390,1593,346,71,71,0
233795,1809,401,71,79,8
209987,1270,403,71,74,3
214772,1932,408,71,71,0
251450,1681,362,71,75,4
202814,1814,402,71,71,0
263230,1786,381,71,81,10
244797,1761,378,71,78,7
224317,1785,377,71,71,0
219709,1803,382,71,74,3
240956,1760,377,71,79,8
219452,1818,394,71,76,5
250939,1135,387,71,71,0
227642,1880,404,71,72,1
211522,1569,322,71,72,1
212282,1890,396,71,71,0
230969,1916,410,71,72,1
158777,1138,390,71,71,0
211513,1890,398,71,71,0
207929,1800,380,71,71,0
205369,1905,393,71,72,1
243956,1731,376,71,71,0
232692,1957,412,71,71,0
229694,1804,393,71,71,0
237630,1681,369,71,82,11
172862,1779,368,71,71,0
242238,1723,394,71,80,9
138306,1808,382,71,71,0
247361,1807,393,71,82,11
213313,1902,403,71,74,3
202305,1919,408,71,71,0
188992,1964,415,71,71,0
243008,1960,412,71,72,1
235840,1058,385,71,76,5
204352,1516,338,71,72,1
245055,1830,393,71,80,9
244287,1829,393,71,78,7
237631,1725,368,71,76,5
232511,1767,379,71,71,0
232255,1898,405,71,71,0
225855,1934,403,71,72,1
211263,1606,349,71,72,1
205887,1761,372,71,73,2
190014,1870,396,71,71,0
236303,1776,386,71,74,3
142721,1161,378,71,71,0
232207,1619,352,71,78,7
237647,1897,402,71,74,3
206159,1768,379,71,71,0
246350,1809,366,71,81,10
233550,1878,403,71,74,3
232526,1789,388,71,76,5
230478,1772,368,71,71,0
221774,1654,355,71,71,0
204366,1819,386,71,72,1
191565,1821,374,71,71,0
251213,1838,396,71,72,1
236621,1656,344,71,72,1
220493,1728,371,71,73,2
215117,1838,393,71,71,0
237132,1846,385,71,78,7
233292,1540,329,71,73,2
225356,1739,371,71,71,0
230479,1821,370,71,71,0
199504,1944,414,71,71,0
243019,1603,358,71,82,11
217168,1784,379,71,72,1
233812,1775,389,71,76,5
207444,1860,404,71,71,0
204372,1780,369,71,71,0
200532,1903,398,71,71,0
185427,1216,407,71,71,0
233299,1712,364,71,75,4
232787,1937,413,71,71,0
191058,1894,399,71,71,0
242514,1085,380,71,72,1
226130,1825,393,71,75,4
239441,1725,385,71,80,9
201041,1809,390,71,71,0
254544,1830,392,71,84,13
236368,1806,391,71,75,4
230480,1690,357,71,71,0
252235,1625,360,71,80,9
200779,1736,373,71,71,0
239306,1852,401,71,79,8
204908,1739,359,71,71,0
252523,1891,414,71,80,9
178283,1205,410,71,71,0
214379,1660,371,71,71,0
224874,1840,389,71,71,0
227689,1949,417,71,72,1
213097,1773,381,71,71,0
211561,1660,352,71,71,0
247144,1938,405,71,74,3
242280,2053,431,71,82,11
232296,1770,383,71,76,5
230248,1677,373,71,71,0
211048,1830,392,71,71,0
203624,1824,376,71,71,0
191079,1550,331,71,71,0
234087,1880,397,71,80,9
203884,1607,350,71,72,1
216428,1684,364,71,71,0
250954,1616,354,71,84,13
222572,1085,380,71,78,7
243530,1551,348,71,82,11
238922,1852,406,71,74,3
237386,1837,391,71,79,8
230474,1707,367,71,71,0
206154,1983,413,71,71,0
200778,1838,409,71,71,0
188782,1534,321,71,71,0
200302,1900,388,71,71,0
194669,1958,411,71,71,0
257133,1758,373,71,81,10
176237,1787,376,71,71,0
213613,1895,398,71,73,2
207725,1568,342,71,71,0
188524,1206,405,71,71,0
253036,1727,369,71,83,12
244308,1749,392,71,76,5
247124,1870,396,71,78,7
220245,1965,404,71,72,1
224198,1842,396,71,76,5
25798,1593,326,71,71,0
115909,1814,367,71,71,0
240837,1832,395,71,72,1
235717,1854,393,71,79,8
214031,1408,306,71,71,0
223685,1660,359,71,71,0
212933,1675,362,71,71,0
138949,1573,326,71,71,0
254660,1828,385,71,82,11
234180,1776,383,71,71,0
230340,1908,405,71,71,0
211908,1287,409,71,72,1
190915,1783,375,71,71,0
248003,1493,333,71,73,2
160195,1774,376,71,71,0
223686,1178,400,71,75,4
230342,1823,381,71,71,0
233045,1709,372,71,78,7
232390,1846,390,71,72,1
18122,1100,379,71,71,0
200138,1667,365,71,72,1
182473,1917,408,71,71,0
247497,1524,342,71,85,14
242633,1842,406,71,80,9
237257,1882,394,71,75,4
198857,1562,343,71,71,0
237256,1820,393,71,75,4
216520,1953,409,71,71,0
176071,1839,374,71,71,0
235719,1906,406,71,76,5
231111,1594,356,71,72,1
229319,1631,358,71,74,3
217287,1933,394,71,73,2
236998,1991,415,71,76,5
211907,1983,408,71,71,0
201155,1816,384,71,71,0
253378,1591,344,71,84,13
239810,1989,416,71,83,12
209597,1520,331,71,72,1
203965,1818,385,71,71,0
186556,1879,404,71,71,0
241499,1701,365,71,71,0
230235,1814,387,71,71,0
251994,1881,388,71,74,3
213337,1932,399,71,73,2
243032,1599,351,71,82,11
219736,1141,388,71,75,4
180823,1852,400,71,71,0
206423,1539,334,71,72,1
261206,1783,385,71,74,3
240982,1858,393,71,72,1
239446,1748,374,71,77,6
208470,1839,381,71,71,0
221629,1764,385,71,71,0
224189,1878,395,71,72,1
163261,1836,380,71,71,0
220609,1963,408,71,74,3
232898,1834,387,71,76,5
224962,1766,373,71,72,1
223426,1638,361,71,71,0
259265,1860,394,71,71,0
192449,1933,413,71,71,0
233409,1726,380,71,79,8
204737,1849,396,71,71,0
211903,1894,404,71,71,0
231360,1925,407,71,74,3
231104,1607,360,71,74,3
242879,1071,389,71,87,16
230335,1866,393,71,71,0
226495,1685,380,71,72,1
214463,1872,388,71,71,0
211559,1904,397,71,71,0
202087,2001,395,71,71,0
243558,1762,375,71,74,3
224146,1807,392,71,71,0
199570,1892,398,71,71,0
253073,1795,389,71,76,5
244625,1864,405,71,78,7
232081,1881,415,71,73,2
225681,1563,334,71,71,0
211857,1897,417,71,72,1
208017,1704,351,71,71,0
244112,1708,371,71,76,5
235152,1736,369,71,81,10
230800,1677,362,71,78,7
222352,1751,373,71,76,5
190607,1762,368,71,71,0
216463,1891,400,71,76,5
193422,1763,370,71,71,0
214158,1750,373,71,71,0
212626,1765,381,71,73,2
225682,1784,384,71,71,0
236696,1771,381,71,77,6
207507,1735,368,71,71,0
242069,1915,409,71,78,7
235413,1098,377,71,78,7
201877,1694,365,71,73,2
255380,1833,395,71,77,6
245396,1583,349,71,82,11
201876,1855,393,71,72,1
199572,1957,411,71,71,0
240787,1901,396,71,84,13
239763,1639,365,71,80,9
231571,1692,367,71,72,1
230291,1740,373,71,71,0
229011,1800,386,71,76,5
221587,1880,396,71,71,0
237440,1624,358,71,78,7
208019,1541,336,71,73,2
192397,1167,384,71,71,0
235405,1600,348,71,78,7
215181,1840,393,71,71,0
229260,1748,391,71,71,0
203910,1921,398,71,71,0
252293,1775,405,71,80,9
190084,1864,383,71,71,0
164484,1160,388,71,71,0
239491,1687,376,71,74,3
230019,1899,402,71,71,0
214659,1415,306,71,72,1
212099,1938,407,71,74,3
188802,1844,377,71,71,0
230786,1886,391,71,82,11
177537,1809,379,71,71,0
240257,1793,384,71,73,2
169345,1951,398,71,71,0
219777,1772,378,71,72,1
143745,1958,393,71,71,0
230278,1815,381,71,71,0
178566,1063,392,71,71,0
223879,1752,371,71,71,0
221323,1577,344,71,78,7
204684,1934,418,71,71,0
200588,1736,377,71,71,0
200332,1104,390,71,72,1
182411,1807,380,71,71,0
246667,1539,339,71,76,5
178571,1226,382,71,71,0
3467,1775,375,71,71,0
234376,1856,397,71,74,3
252042,1647,358,71,84,13
171146,1296,401,71,71,0
199562,1848,380,71,71,0
234889,1828,399,71,76,5
230281,1808,364,71,71,0
202889,1803,383,71,72,1
236695,1881,407,71,78,7
184472,1914,405,71,71,0
242534,1912,407,71,81,10
199776,1712,354,71,71,0
231007,1924,402,71,71,0
236382,1856,401,71,71,0
200798,1178,388,71,71,0
234333,1702,366,71,76,5
233053,1895,404,71,78,7
225629,1956,408,71,75,4
220509,1613,353,71,74,3
240988,1676,365,71,78,7
239964,1784,389,71,74,3
172198,1139,404,71,71,0
232358,1727,376,71,71,0
228518,1664,361,71,76,5
228517,1911,421,71,76,5
220837,1865,411,71,71,0
211365,1861,401,71,72,1
231263,1668,357,71,77,6
188000,1889,395,71,71,0
200857,1888,390,71,71,0
226401,1773,369,71,76,5
260965,1693,375,71,76,5
191333,1915,413,71,71,0
246885,1948,420,71,77,6
214373,1159,381,71,71,0
211557,1619,359,71,72,1
167524,1858,391,71,71,0
213092,1697,362,71,72,1
205156,1892,406,71,71,0
261987,1755,370,71,83,12
242019,1657,363,71,76,5
173155,2013,427,71,71,0
194146,1563,333,71,71,0
176993,1720,353,71,71,0
237153,1945,416,71,75,4
233057,1874,393,71,76,5
209061,1801,387,71,71,0
248484,1524,346,71,82,11
245156,1556,338,71,75,4
209828,1878,398,71,72,1
220061,1443,319,71,71,0
212381,1728,359,71,72,1
191388,1834,396,71,71,0
253340,1855,390,71,71,0
251292,991,375,71,75,4
242075,1813,388,71,82,11
213659,1811,398,71,75,4
189338,1816,374,71,71,0
238490,1689,360,71,77,6
230298,1785,371,71,71,0
220826,1626,344,71,71,0
220058,1150,391,71,74,3
219546,1741,380,71,74,3
237209,1669,357,71,74,3
203161,1428,322,71,71,0
220829,1714,363,71,71,0
233885,1725,377,71,82,11
184477,1643,335,71,71,0
229537,1616,345,71,76,5
134820,1799,368,71,71,0
216483,1725,386,71,73,2
186274,1993,419,71,71,0
229282,1716,368,71,71,0
189857,1885,387,71,71,0
255137,1853,400,71,78,7
245152,1754,383,71,84,13
230302,1772,361,71,71,0
242335,1776,388,71,74,3
234399,1793,378,71,77,6
232607,1605,343,71,73,2
205983,1932,413,71,71,0
262815,1792,401,71,71,0
191390,1891,407,71,71,0
234698,1736,366,71,71,0
239904,1590,356,71,73,2
241872,1566,340,71,78,7
220620,1811,398,71,72,1
253912,1674,372,71,71,0
198617,1752,371,71,71,0
195033,1875,404,71,71,0
205530,1297,411,71,71,0
216282,1678,366,71,74,3
230362,1790,388,71,71,0
239322,1452,313,71,71,0
155355,1846,389,71,71,0
234203,1790,373,71,78,7
241115,1732,357,71,75,4
124635,1863,385,71,71,0
202716,1767,363,71,71,0
259036,1868,400,71,82,11
196316,1122,388,71,71,0
217565,1530,328,71,73,2
217821,1738,385,71,72,1
215262,1792,375,71,71,0
222430,1824,389,71,71,0
234624,1818,402,71,71,0
212608,1756,381,71,71,0
251775,1936,416,71,76,5
165247,1351,404,71,71,0
220031,1695,359,71,75,4
246398,1047,377,71,77,6
110974,1223,406,71,71,0
241278,1856,393,71,80,9
222590,1742,372,71,74,3
199550,1610,346,71,71,0
188541,1941,415,71,71,0
237784,1930,413,71,71,0
208856,1859,397,71,71,0
233943,1890,410,71,79,8
216530,1717,362,71,71,0
244428,1925,409,71,75,4
200653,1596,342,71,71,0
203725,1739,375,71,71,0
235981,1882,403,71,73,2
190669,1132,383,71,72,1
210126,1870,383,71,71,0
219174,1830,389,71,71,0
216270,1962,416,71,72,1
189390,1910,399,71,71,0
215247,1819,381,71,73,2
235983,1900,396,71,79,8
246388,1488,324,71,79,8
182224,1320,408,71,71,0
237522,1591,337,71,82,11
230359,1895,398,71,71,0
241362,1873,408,71,71,0
212947,1725,374,71,71,0
234195,1955,413,71,74,3
190931,1725,350,71,71,0
210644,1804,379,71,72,1
232148,1818,391,71,73,2
226773,1851,404,71,76,5
177621,1200,404,71,71,0
184789,1674,345,71,71,0
204246,1102,387,71,73,2
258262,1841,390,71,76,5
263383,1842,399,71,79,8
217047,1703,355,71,71,0
244349,1634,355,71,82,11
242045,1902,410,71,78,7
220029,1823,383,71,74,3
229496,1583,339,71,71,0
230516,1548,326,71,71,0
238196,1763,387,71,80,9
243828,1872,394,71,82,11
240507,1863,387,71,81,10
234875,1735,369,71,72,1
223867,1895,392,71,73,2
224378,1389,311,71,72,1
223866,1842,386,71,80,9
233849,1741,376,71,72,1
230521,1729,366,71,71,0
218745,1992,418,71,76,5
214393,1838,406,71,71,0
230776,1494,329,71,73,2
201335,1779,376,71,71,0
195698,1924,403,71,71,0
193910,1888,397,71,71,0
255862,1674,363,71,82,11
179574,1737,358,71,71,0
232054,1745,387,71,71,0
220534,1745,365,71,77,6
208502,1807,386,71,71,0
142966,1820,371,71,71,0
207734,1958,407,71,72,1
193909,1812,378,71,71,0
243061,1755,387,71,77,6
235125,1790,388,71,77,6
216437,1506,330,71,73,2
202101,1726,360,71,71,0
228980,1856,394,71,72,1
192114,1694,357,71,73,2
215165,1907,403,71,71,0
252961,1653,368,71,85,14
243580,1763,390,71,81,10
204412,1971,410,71,71,0
215334,1714,355,71,71,0
210214,1872,389,71,71,0
225317,1835,386,71,75,4
207653,1793,383,71,71,0
201509,1926,406,71,71,0
223524,1433,308,71,72,1
210468,1630,335,71,72,1
181795,1790,385,71,71,0
244259,1650,360,71,74,3
214562,1674,369,71,71,0
206626,1762,379,71,71,0
211489,1823,383,71,71,0
188274,1713,368,71,71,0
202017,1750,386,71,71,0
198177,1760,385,71,71,0
241696,1913,418,71,75,4
208769,1907,395,71,71,0
243055,1829,396,71,80,9
207472,1893,402,71,71,0
164464,1779,368,71,71,0
220529,1898,402,71,76,5
230257,1922,401,71,71,0
230513,1792,374,71,71,0
183921,1916,396,71,71,0
227186,1144,390,71,76,5
252018,1853,408,71,79,8
240332,1698,362,71,81,10
184436,1222,410,71,71,0
189899,1646,329,71,71,0
200715,1078,386,71,73,2
238008,1438,322,71,74,3
199353,1934,401,71,71,0
224442,1107,387,71,76,5
235450,1752,370,71,81,10
204731,1855,393,71,71,0
233147,1996,420,71,71,0
202940,1833,381,71,71,0
230332,1110,392,71,74,3
223498,1890,408,71,78,7
241162,1781,380,71,78,7
257290,1866,401,71,83,12
192778,1862,391,71,71,0
262411,1985,420,71,76,5
163083,1564,317,71,71,0
242359,1483,323,71,76,5
232459,1733,373,71,75,4
225995,1865,402,71,75,4
183820,1811,375,71,71,0
158221,1769,365,71,71,0
229901,1495,323,71,79,8
245261,1795,380,71,72,1
189709,1608,334,71,71,0
233230,1712,370,71,80,9
244238,1829,397,71,79,8
250797,1031,380,71,71,0
230316,1784,385,71,71,0
254891,1736,389,71,74,3
242603,1546,343,71,80,9
224440,1113,382,71,75,4
216750,1267,388,71,71,0
221367,1804,384,71,72,1
185010,1704,348,71,71,0
204215,1931,417,71,71,0
202678,1814,399,71,71,0
184501,1892,401,71,71,0
240309,1874,394,71,71,0
240053,1896,406,71,71,0
221621,1490,312,71,71,0
238004,1783,391,71,77,6
222644,1921,407,71,71,0
210868,1902,395,71,71,0
208564,1930,407,71,71,0
233139,1738,376,71,77,6
221875,1885,394,71,71,0
148403,1933,399,71,71,0
257713,1805,396,71,81,10
241070,1597,356,71,77,6
188337,2105,444,71,71,0
247729,1862,398,71,80,9
244401,1548,351,71,80,9
213937,1916,391,71,71,0
212401,1698,369,71,71,0
256688,1953,429,71,78,7
204464,1977,408,71,72,1
182959,1032,378,71,71,0
228271,1787,389,71,71,0
217007,1771,380,71,71,0
216751,1645,353,71,71,0
214191,1640,356,71,71,0
209839,1811,375,71,73,2
230315,1040,387,71,71,0
192938,1772,376,71,71,0
242602,1763,404,71,82,11
243497,1581,351,71,81,10
203568,1848,402,71,71,0
176942,1787,380,71,71,0
199982,1792,384,71,71,0
244269,1655,367,71,77,6
241197,1584,340,71,78,7
219181,1924,400,71,71,0
144429,1932,398,71,71,0
185132,1827,386,71,71,0
234028,1774,372,71,71,0
219180,1654,346,71,74,3
240683,1899,410,71,80,9
234795,1856,397,71,78,7
228650,1804,375,71,74,3
224041,1306,403,71,75,4
213418,1714,376,71,75,4
177448,1719,354,71,71,0
258343,1978,421,71,78,7
232230,1863,399,71,72,1
229158,1960,417,71,74,3
221990,1415,301,71,72,1
220198,1771,376,71,74,3
243402,1730,379,71,74,3
248266,1771,387,71,79,8
256970,1773,367,71,84,13
198347,1809,383,71,71,0
138699,1964,396,71,71,0
210123,1877,392,71,71,0
224459,1783,396,71,71,0
234032,1656,361,71,77,6
235824,1814,387,71,80,9
198193,1780,379,71,71,0
220209,1879,403,71,71,0
212138,1825,402,71,72,1
142762,1612,335,71,71,0
227497,1193,390,71,73,2
212137,1845,402,71,73,2
238504,1859,388,71,77,6
202408,1494,322,71,71,0
256167,1904,401,71,79,8
189607,1665,355,71,71,0
223143,1743,386,71,75,4
239782,2026,437,71,71,0
191032,1877,403,71,71,0
253240,1733,374,71,80,9
186680,1163,386,71,71,0
243000,1954,415,71,71,0
139064,1901,378,71,71,0
196151,1923,396,71,71,0
192567,1842,393,71,71,0
244790,1776,380,71,73,2
222262,1698,368,71,73,2
230964,1866,393,71,71,0
244787,1835,393,71,72,1
240947,1720,369,71,79,8
232755,1782,384,71,78,7
230451,1978,414,71,71,0
202035,1783,372,71,71,0
220466,1935,408,71,72,1
240689,1804,391,71,71,0
220087,1860,421,71,71,0
188421,1867,396,70,70,0
230144,1810,380,70,76,6
230400,1512,335,70,70,0
246279,1666,366,70,76,6
157703,1702,334,70,70,0
219911,1457,314,70,70,0
210951,1815,378,70,71,1
201991,1747,361,70,70,0
235782,1888,406,70,75,5
233222,1720,387,70,77,7
185349,1872,394,70,70,0
214021,1611,351,70,70,0
243716,1762,388,70,73,3
241412,1790,388,70,70,0
233732,1668,371,70,76,6
222724,1796,375,70,75,5
190467,1888,390,70,70,0
213763,1817,375,70,70,0
251138,1597,344,70,70,0
241410,1737,371,70,82,12
226050,1736,376,70,73,3
225282,1170,388,70,73,3
215042,1755,370,70,70,0
200962,1936,404,70,70,0
238593,1750,390,70,72,2
204289,1757,373,70,70,0
186130,1679,348,70,70,0
214817,1869,400,70,70,0
212519,1760,375,70,70,0
260136,1586,346,70,80,10
223790,1791,388,70,71,1
238637,1898,408,70,75,5
246316,1874,400,70,74,4
243756,1735,386,70,70,0
230444,1619,356,70,70,0
144172,1144,393,70,70,0
244523,1777,379,70,79,9
106795,1123,379,70,70,0
235563,1785,382,70,73,3
230443,1797,386,70,70,0
210219,1625,346,70,70,0
202539,1786,360,70,70,0
258090,1794,385,70,76,6
189482,1909,402,70,70,0
221994,1950,417,70,73,3
204842,1164,381,70,73,3
221737,1831,401,70,73,3
214313,1772,380,70,70,0
209449,1798,384,70,70,0
230190,1799,380,70,70,0
245550,1633,351,70,73,3
251438,1883,409,70,80,10
258608,1750,380,70,77,7
230194,1694,355,70,70,0
200754,1975,417,70,70,0
192561,1849,392,70,70,0
246321,1851,395,70,75,5
243249,1864,398,70,79,9
230193,1827,382,70,70,0
217649,1203,389,70,70,0
226060,1801,381,70,70,0
252208,1838,387,70,81,11
252974,1794,388,70,77,7
186672,1809,369,70,70,0
244272,1517,349,70,71,1
240944,1583,350,70,75,5
228144,1952,414,70,71,1
211504,1971,410,70,74,4
244271,1797,395,70,73,3
225071,1894,402,70,75,5
223791,1861,392,70,73,3
200489,1702,365,70,70,0
233512,1731,378,70,71,1
211239,1801,380,70,72,2
203304,1791,380,70,70,0
244497,1770,389,70,79,9
246033,1777,385,70,80,10
184337,1963,409,70,70,0
259345,1781,371,70,75,5
227602,1698,371,70,70,0
230936,1890,391,70,74,4
199960,1772,369,70,70,0
236823,1228,389,70,77,7
253718,1594,340,70,77,7
239894,1841,397,70,77,7
214294,1940,428,70,70,0
254229,1756,389,70,70,0
241941,1704,374,70,76,6
219413,1705,380,70,70,0
196885,1176,379,70,70,0
177684,1800,376,70,70,0
199700,1742,371,70,70,0
242195,1592,361,70,82,12
221459,1712,359,70,70,0
238097,1748,381,70,73,3
163600,1092,390,70,70,0
227600,1843,395,70,74,4
257293,1817,398,70,78,8
252711,1872,407,70,71,1
245543,1785,386,70,74,4
229900,1896,413,70,75,5
233484,1958,420,70,77,7
238860,1455,316,70,71,1
256268,1663,365,70,84,14
232461,1595,351,70,71,1
241933,1904,404,70,81,11
242958,1595,350,70,77,7
222224,1899,402,70,70,0
210703,1728,370,70,71,1
215823,1441,317,70,71,1
220175,1974,427,70,75,5
230415,1655,358,70,70,0
233487,1979,425,70,77,7
233999,1130,399,70,70,0
199952,1856,376,70,70,0
156432,1776,354,70,70,0
186674,1976,408,70,70,0
194354,1981,418,70,70,0
213556,1861,405,70,70,0
229428,1695,368,70,71,1
202530,1826,393,70,70,0
204307,1802,384,70,70,0
205089,1807,373,70,70,0
247072,1094,386,70,70,0
194079,1882,398,70,70,0
228383,1108,386,70,78,8
198687,1912,415,70,70,0
194846,1824,394,70,70,0
258334,1909,402,70,71,1
230686,1915,405,70,78,8
205086,1841,364,70,70,0
262430,1730,367,70,73,3
194077,1816,387,70,70,0
258333,1623,367,70,72,2
216349,1770,362,70,74,4
259868,1829,392,70,82,12
258332,1814,392,70,70,0
189211,1831,390,70,70,0
186651,1997,414,70,70,0
209698,1767,365,70,70,0
218658,1637,386,70,74,4
227106,1670,364,70,75,5
245540,1593,354,70,77,7
244006,1625,347,70,72,2
242214,1647,363,70,79,9
234790,1160,381,70,77,7
233510,1784,390,70,80,10
251429,1623,363,70,76,6
212261,1818,377,70,73,3
256548,1734,383,70,76,6
255268,1795,391,70,80,10
240164,1643,360,70,70,0
239138,1652,367,70,78,8
230180,1159,392,70,70,0
225316,1746,390,70,74,4
194083,1668,335,70,70,0
223779,1925,409,70,73,3
262435,1697,354,70,71,1
253218,1643,347,70,70,0
186402,1617,343,70,70,0
246562,1940,427,70,75,5
186139,1860,386,70,70,0
248091,1232,392,70,70,0
241947,1784,378,70,79,9
224524,1565,333,70,71,1
239881,1720,364,70,78,8
176137,1826,368,70,70,0
243977,1620,359,70,70,0
251401,1716,379,70,81,11
192009,1234,398,70,72,2
230410,1655,365,70,70,0
240138,1601,342,70,72,2
203276,1694,356,70,70,0
230454,1730,381,70,70,0
224265,1815,383,70,77,7
200758,1649,366,70,70,0
198198,1653,363,70,70,0
193077,1599,343,70,70,0
242997,1643,360,70,78,8
239669,1743,374,70,73,3
235317,1786,392,70,70,0
213557,1941,404,70,70,0
213301,1849,385,70,73,3
231433,1734,367,70,72,2
215049,1863,390,70,70,0
234779,1200,384,70,73,3
230169,1103,375,70,70,0
226075,1853,394,70,70,0
203547,1842,392,70,70,0
224794,1833,397,70,70,0
198426,1957,412,70,70,0
194841,1698,366,70,70,0
255001,1821,383,70,87,17
245785,1578,338,70,73,3
245017,1749,385,70,76,6
225305,1809,383,70,70,0
197641,1052,387,70,70,0
212249,1856,388,70,71,1
208153,1682,345,70,70,0
235544,1733,378,70,70,0
189703,1723,356,70,70,0
213000,1544,328,70,70,0
229896,1856,397,70,73,3
231688,1600,346,70,73,3
234760,1819,396,70,71,1
198705,1929,407,70,70,0
237051,1746,381,70,70,0
242660,1667,364,70,79,9
216802,1784,383,70,73,3
233954,1771,394,70,74,4
194018,1788,378,70,70,0
224995,1753,383,70,73,3
246755,1722,377,70,79,9
190435,1155,384,70,70,0
229092,1834,399,70,70,0
234980,1886,410,70,70,0
203749,1484,328,70,70,0
230377,1815,378,70,70,0
222693,1777,386,70,70,0
212454,1772,383,70,71,1
226278,1770,376,70,70,0
228326,1857,397,70,71,1
237286,1648,350,70,77,7
187110,1866,398,70,70,0
259047,1862,406,70,76,6
211177,1917,409,70,70,0
209378,1882,377,70,70,0
194017,1864,397,70,70,0
239073,1647,362,70,70,0
213729,1236,393,70,76,6
232413,1681,374,70,75,5
233437,1669,366,70,70,0
241629,1838,391,70,79,9
246237,1707,380,70,77,7
251613,1775,384,70,78,8
189661,1668,363,70,70,0
195037,1357,288,70,70,0
208862,1618,348,70,70,0
214238,1788,373,70,71,1
225502,1865,414,70,77,7
183518,1827,370,70,70,0
220383,1218,379,70,75,5
231391,1761,363,70,76,6
241119,1167,395,70,78,8
242143,1888,397,70,71,1
199392,1907,401,70,70,0
206561,1052,382,70,74,4
213993,1702,356,70,70,0
233705,1838,393,70,76,6
233079,1758,383,70,75,5
227911,1739,360,70,75,5
239432,1737,370,70,74,4
237640,1828,395,70,81,11
233544,1799,388,70,73,3
213064,1785,378,70,70,0
211272,1816,384,70,70,0
144200,1942,411,70,70,0
186695,1517,326,70,70,0
232775,1918,406,70,70,0
192838,1809,390,70,70,0
248297,1808,372,70,70,0
243270,1787,379,70,76,6
223046,1666,354,70,71,1
222278,1699,378,70,70,0
235589,1533,336,70,77,7
231237,1233,375,70,75,5
223045,1824,394,70,70,0
213317,1798,381,70,70,0
229956,1170,380,70,78,8
179528,1841,378,70,70,0
235849,1637,354,70,76,6
239945,1836,387,70,77,7
245065,1655,367,70,80,10
253929,1769,382,70,72,2
191209,1761,383,70,70,0
202986,1936,401,70,70,0
211946,1147,384,70,70,0
250858,1762,382,70,73,3
192490,1900,402,70,70,0
210923,1182,383,70,70,0
236267,1540,332,70,74,4
179947,1762,365,70,70,0
252139,1873,395,70,78,8
258027,1601,354,70,73,3
230380,1821,386,70,70,0
224591,1836,380,70,74,4
192074,1961,408,70,70,0
244042,1717,377,70,79,9
233034,1800,375,70,73,3
223818,1521,326,70,70,0
228829,1442,307,70,70,0
213725,1939,405,70,74,4
210653,1627,354,70,70,0
240311,1040,378,70,78,8
260020,1754,384,70,83,13
216245,1248,387,70,73,3
234933,1594,337,70,71,1
245429,1835,393,70,78,8
186805,1777,377,70,70,0
225974,1515,333,70,77,7
228790,1714,378,70,76,6
242614,1667,362,70,76,6
250807,1756,382,70,79,9
203485,1775,374,70,73,3
211384,1774,389,70,70,0
257208,1682,363,70,83,13
223929,1785,380,70,75,5
182713,1453,294,70,70,0
224186,1640,343,70,73,3
231098,1696,367,70,70,0
261050,1643,353,70,86,16
215995,1743,378,70,70,0
245428,1684,368,70,76,6
239475,1895,404,70,75,5
251763,1735,376,70,75,5
202356,1773,381,70,70,0
194934,1258,391,70,70,0
177782,1901,381,70,70,0
242294,1828,390,70,80,10
105846,1111,367,70,70,0
169078,1883,392,70,70,0
193141,1863,389,70,70,0
250997,1775,383,70,80,10
244853,1844,394,70,79,9
243573,959,368,70,75,5
177525,1945,416,70,70,0
237429,1524,325,70,73,3
226677,1980,423,70,77,7
247412,1728,380,70,82,12
247156,1777,391,70,77,7
239732,1950,426,70,77,7
229236,1773,380,70,74,4
225908,1624,352,70,77,7
224187,1904,411,70,70,0
261307,1761,376,70,79,9
219836,1137,384,70,72,2
208581,1822,388,70,73,3
213445,1783,375,70,70,0
242629,1707,363,70,77,7
256197,1646,358,70,80,10
213702,1809,380,70,73,3
233926,1530,321,70,77,7
219591,1421,316,70,73,3
230343,1836,386,70,70,0
237255,1574,358,70,77,7
248775,1693,366,70,70,0
212424,1819,377,70,71,1
215496,1767,380,70,70,0
219848,1730,371,70,75,5
237512,1902,415,70,76,6
186568,1955,406,70,70,0
188616,1776,378,70,70,0
198601,1824,390,70,70,0
261084,1687,364,70,79,9
213189,1814,386,70,70,0
242372,1632,365,70,70,0
231868,1686,355,70,74,4
228804,1958,403,70,75,5
237245,1546,343,70,76,6
245437,1621,355,70,81,11
202686,1841,383,70,70,0
219582,1502,327,70,70,0
220862,1767,376,70,70,0
237502,1687,370,70,74,4
254910,1820,377,70,74,4
224191,1877,392,70,74,4
210880,1820,400,70,70,0
219584,1132,387,70,73,3
253376,1662,365,70,80,10
219841,1740,385,70,73,3
194753,1912,394,70,70,0
262081,1660,363,70,80,10
253890,1751,390,70,70,0
208835,1976,423,70,70,0
216003,1785,384,70,75,5
224836,1306,398,70,75,5
253251,1736,374,70,80,10
241731,1770,377,70,70,0
239708,1682,360,70,76,6
192476,1686,347,70,70,0
192732,1918,400,70,70,0
253278,1629,355,70,79,9
237662,1887,401,70,73,3
214366,1867,398,70,70,0
225117,1900,406,70,73,3
218717,1628,355,70,70,0
211037,1749,379,70,70,0
259675,1827,403,70,78,8
217813,1182,385,70,74,4
253275,1771,383,70,71,1
179547,1257,397,70,70,0
255578,1594,360,70,72,2
184154,1927,407,70,70,0
246106,1744,387,70,78,8
240730,1702,369,70,76,6
225114,1839,387,70,71,1
158810,1880,382,70,70,0
235740,1023,379,70,72,2
232156,1795,403,70,76,6
228828,1620,366,70,77,7
255963,1863,388,70,72,2
235989,1691,373,70,75,5
248021,1621,352,70,72,2
198614,1582,310,70,70,0
200918,1859,393,70,70,0
214998,1885,389,70,70,0
236758,1116,382,70,78,8
204247,1781,378,70,70,0
239575,1504,325,70,75,5
189655,1703,364,70,70,0
208088,1663,349,70,73,3
229336,1931,404,70,77,7
236760,1816,380,70,76,6
244952,1743,380,70,79,9
160217,1813,382,70,70,0
206042,1896,407,70,70,0
261082,1796,387,70,83,13
189403,1480,315,70,70,0
230233,1838,395,70,70,0
211033,1243,397,70,72,2
258648,1682,366,70,78,8
234578,1799,380,70,70,0
236369,1486,334,70,79,9
236113,1741,370,70,70,0
160081,1796,374,70,70,0
258128,1808,383,70,79,9
243792,1756,376,70,78,8
209232,1564,337,70,73,3
203344,1509,329,70,70,0
252239,1851,394,70,80,10
241487,1815,389,70,82,12
230991,1782,378,70,70,0
238924,1739,370,70,70,0
254028,1634,357,70,70,0
201549,1749,359,70,70,0
224590,1909,398,70,73,3
228942,1833,404,70,73,3
255566,1829,395,70,82,12
208719,1195,399,70,70,0
225106,1739,375,70,77,7
239186,1717,375,70,70,0
245336,1678,365,70,78,8
243538,1001,377,70,75,5
242776,1842,398,70,73,3
231512,1739,384,70,80,10
223064,1489,320,70,72,2
201304,1930,407,70,70,0
256343,1751,369,70,77,7
241238,1914,403,70,76,6
236630,1755,378,70,71,1
232278,1700,369,70,71,1
230486,1724,375,70,70,0
200278,1810,385,70,70,0
183893,1737,362,70,70,0
239701,1801,389,70,79,9
232789,1828,379,70,70,0
257876,1898,401,70,80,10
213332,1605,347,70,71,1
207956,1936,425,70,71,1
197971,1858,397,70,70,0
160213,1751,367,70,70,0
214485,1836,391,70,70,0
247106,1951,417,70,82,12
246070,1809,389,70,82,12
199738,1664,361,70,70,0
233529,1922,401,70,70,0
167993,1306,395,70,70,0
226616,1813,387,70,70,0
204344,1720,363,70,70,0
201528,1807,382,70,70,0
260407,1766,382,70,81,11
226103,1734,380,70,79,9
255487,1908,407,70,70,0
223188,1924,408,70,70,0
221695,1983,416,70,75,5
193278,1716,389,70,70,0
230398,1483,313,70,70,0
215294,1770,368,70,70,0
211966,1789,390,70,73,3
208638,1754,379,70,70,0
205054,1913,405,70,70,0
224509,1841,391,70,74,4
202810,1131,381,70,73,3
159034,1651,349,70,70,0
228410,1128,392,70,75,5
199739,1882,374,70,70,0
241474,1717,379,70,76,6
258881,1944,422,70,77,7
223553,1644,358,70,70,0
206145,1031,384,70,72,2
237376,1884,404,70,73,3
227903,1707,364,70,80,10
199487,1665,337,70,70,0
247870,1739,376,70,79,9
245054,1851,398,70,75,5
242494,1685,352,70,72,2
194365,1861,384,70,70,0
206141,1627,364,70,70,0
204349,975,380,70,70,0
233532,1813,383,70,70,0
229692,1260,410,70,71,1
230459,1729,359,70,70,0
230203,1797,372,70,70,0
217085,1777,382,70,71,1
205565,1548,333,70,70,0
248060,1739,382,70,76,6
259788,1861,407,70,78,8
214990,1846,407,70,70,0
223694,1837,384,70,70,0
232654,961,369,70,78,8
184271,1974,419,70,70,0
201936,1089,376,70,70,0
222160,1826,394,70,73,3
229584,1828,391,70,73,3
254928,1815,395,70,80,10
263377,1721,371,70,79,9
210129,1951,413,70,70,0
204242,1786,377,70,70,0
245714,1669,370,70,78,8
257234,1903,408,70,80,10
198611,1869,389,70,70,0
202451,1684,355,70,70,0
235987,1788,384,70,76,6
198868,1524,321,70,70,0
192205,1670,346,70,70,0
246732,1694,373,70,78,8
223740,1863,386,70,70,0
226508,1860,392,70,76,6
217852,1869,397,70,70,0
215292,1813,372,70,70,0
198908,1899,395,70,70,0
244987,1101,379,70,70,0
239099,1733,376,70,76,6
230601,1775,375,70,75,5
230857,1745,367,70,70,0
239049,1765,383,70,77,7
243401,1686,366,70,78,8
248777,1719,381,70,71,1
209610,1874,392,70,70,0
224970,1873,381,70,71,1
227530,1750,370,70,70,0
244938,1532,340,70,76,6
236747,1805,379,70,70,0
239307,1677,361,70,77,7
219852,1660,354,70,73,3
230263,1793,373,70,70,0
213839,1635,350,70,73,3
247671,1854,391,70,70,0
178319,1776,360,70,70,0
228761,1711,359,70,77,7
212121,1893,402,70,76,6
203929,1671,345,70,70,0
202905,1795,390,70,70,0
230296,1740,362,70,70,0
251287,1851,403,70,78,8
205463,1815,386,70,70,0
198039,1162,383,70,72,2
186518,1804,370,70,70,0
243350,1820,389,70,81,11
165526,1463,304,70,70,0
208534,1541,341,70,72,2
228245,1914,397,70,70,0
246164,1758,378,70,75,5
245652,1648,360,70,75,5
230292,1762,361,70,70,0
220820,1189,394,70,72,2
240019,1734,372,70,80,10
221331,1820,377,70,75,5
226706,1693,364,70,71,1
247185,1879,404,70,79,9
232593,1651,369,70,70,0
225169,1769,371,70,71,1
223633,1839,391,70,73,3
212625,1857,406,70,72,2
210833,1780,389,70,70,0
197777,1923,401,70,70,0
246928,1704,366,70,79,9
237712,1740,374,70,78,8
234905,1834,391,70,75,5
246169,1622,345,70,80,10
198554,1710,355,70,70,0
193182,1229,393,70,70,0
212129,1652,357,70,73,3
198817,1828,384,70,70,0
251511,1074,390,70,71,1
241568,1944,410,70,78,8
172960,1723,356,70,70,0
220064,1814,378,70,73,3
214944,1731,364,70,75,5
201888,1890,405,70,71,1
246431,1665,363,70,82,12
244895,1820,395,70,83,13
242079,1824,398,70,80,10
240031,1823,399,70,74,4
204447,1578,321,70,70,0
232350,1070,383,70,76,6
209818,1713,378,70,70,0
232094,1658,366,70,73,3
205214,1866,403,70,70,0
236189,1786,374,70,70,0
233884,1851,399,70,76,6
216476,1817,394,70,70,0
215708,1785,390,70,70,0
237211,1878,395,70,75,5
230299,1673,351,70,70,0
53914,1698,315,70,70,0
241050,980,374,70,70,0
240282,1800,391,70,74,4
220314,1176,382,70,70,0
216730,1627,359,70,75,5
213136,1767,372,70,70,0
240783,1760,382,70,82,12
194149,1968,414,70,70,0
240271,1772,378,70,76,6
252037,1614,346,70,85,15
246405,1621,352,70,74,4
219525,1795,382,70,70,0
242052,1760,365,70,76,6
236164,1778,361,70,70,0
214660,1934,401,70,70,0
214404,1441,297,70,72,2
246403,1799,392,70,70,0
239747,1607,354,70,77,7
230531,1781,378,70,70,0
229251,1881,407,70,70,0
150659,1166,392,70,70,0
215391,1618,346,70,70,0
193631,1789,379,70,70,0
216416,1753,385,70,72,2
234848,1804,393,70,77,7
239200,1848,400,70,73,3
192608,1909,399,70,70,0
184417,1990,417,70,70,0
252001,1744,383,70,77,7
186977,1544,327,70,70,0
259681,1694,368,70,82,12
214882,1560,325,70,70,0
222562,1172,396,70,74,4
223843,1183,384,70,70,0
230243,1879,375,70,70,0
253283,1732,369,70,86,16
206436,1885,382,70,71,1
161636,1809,365,70,70,0
202886,1124,378,70,71,1
214918,1819,387,70,70,0
234630,1748,372,70,70,0
246666,1674,370,70,82,12
236175,1760,370,70,70,0
214415,1144,384,70,72,2
212879,1821,389,70,70,0
204687,1840,397,70,70,0
264335,1933,408,70,81,11
208014,1633,353,70,71,1
242573,1729,375,70,78,8
237453,1760,383,70,74,4
184716,1960,406,70,70,0
246155,1854,399,70,80,10
211339,1813,381,70,70,0
253322,1948,409,70,70,0
251530,1862,409,70,80,10
227978,1797,385,70,76,6
242054,1869,399,70,75,5
253321,1896,387,70,71,1
183177,1783,367,70,70,0
172425,1337,298,70,70,0
233097,1585,335,70,77,7
225673,1680,364,70,73,3
212104,1891,408,70,70,0
200840,1688,366,70,72,2
191111,1951,416,70,70,0
173703,1771,386,70,70,0
229255,1100,368,70,73,3
193414,1946,405,70,70,0
245894,1673,360,70,82,12
178310,1622,355,70,70,0
223905,1763,384,70,74,4
164769,1697,350,70,70,0
215970,1895,411,70,72,2
239778,1943,412,70,82,12
162221,1792,361,70,70,0
215213,1183,403,70,76,6
188844,1633,339,70,70,0
246444,1805,400,70,75,5
222636,1669,357,70,73,3
247723,1724,369,70,78,8
170923,1836,391,70,70,0
235947,1846,387,70,75,5
232875,1831,387,70,70,0
220075,1946,421,70,71,1
233642,1834,394,70,75,5
222634,1740,375,70,75,5
233897,1790,394,70,70,0
246696,1593,356,70,70,0
231848,1840,389,70,76,6
199848,1843,380,70,70,0
205735,1788,377,70,70,0
244390,1823,402,70,70,0
204966,1311,403,70,72,2
244389,1637,364,70,81,11
237477,1726,375,70,80,10
204709,1906,391,70,70,0
247972,2014,426,70,77,7
242084,1051,373,70,75,5
225956,1813,395,70,73,3
222116,1825,405,70,73,3
234476,1508,341,70,70,0
239340,1422,301,70,76,6
244204,1502,340,70,76,6
240045,1891,405,70,75,5
189357,1323,397,70,70,0
205998,1892,408,70,71,1
242865,1687,374,70,77,7
241588,1740,378,70,78,8
238516,1643,356,70,80,10
232884,1822,382,70,70,0
202676,1823,392,70,70,0
198836,1906,389,70,70,0
253619,1777,381,70,80,10
232883,1952,406,70,70,0
225203,1135,392,70,75,5
199347,1526,315,70,70,0
221618,1704,367,70,74,4
142258,1172,388,70,70,0
193201,2002,416,70,70,0
255409,1767,382,70,77,7
167601,1826,392,70,70,0
214190,1183,384,70,70,0
163761,1484,312,70,70,0
208817,1915,399,70,70,0
143025,1892,389,70,70,0
209840,1626,347,70,70,0
241071,1919,399,70,78,8
233647,1551,329,70,70,0
225455,1795,375,70,77,7
225199,1921,389,70,75,5
219823,1616,338,70,70,0
258478,1924,409,70,76,6
254894,1726,363,70,75,5
235950,1637,354,70,70,0
228782,1837,395,70,74,4
155885,1821,380,70,70,0
244205,1705,374,70,75,5
210926,1687,341,70,70,0
198394,1784,378,70,70,0
189430,1134,376,70,70,0
152567,1920,391,70,70,0
232183,1728,379,70,70,0
233207,1802,408,70,71,1
246263,1692,376,70,80,10
257271,1769,382,70,83,13
239096,1573,343,70,73,3
199417,1052,384,70,70,0
214777,1737,364,70,70,0
221433,1937,392,70,74,4
225785,1588,351,70,77,7
232185,1771,389,70,76,6
195065,1825,372,70,70,0
205818,1911,399,70,72,2
242934,1284,399,70,73,3
217082,1467,321,70,72,2
230394,1759,381,70,70,0
233978,1649,356,70,70,0
254714,1182,382,70,74,4
200443,1942,397,70,70,0
235515,1720,379,70,71,1
219812,1724,364,70,72,2
256675,1759,375,70,79,9
182435,1073,361,70,70,0
246947,1776,382,70,78,8
142499,1899,388,70,70,0
247458,1771,394,70,76,6
246690,1575,344,70,75,5
246006,1823,389,70,77,7
248053,1781,388,70,78,8
230382,1759,375,70,70,0
212466,1804,386,70,70,0
225775,1651,367,70,76,6
228591,1770,382,70,75,5
230383,1586,335,70,70,0
241135,1723,379,70,70,0
245999,1766,379,70,81,11
246255,1803,381,70,79,9
247279,1680,361,70,74,4
228080,1956,410,70,75,5
242160,1700,378,70,72,2
179696,1911,397,70,70,0
200689,1961,421,70,70,0
236529,1798,401,70,79,9
251377,1896,410,70,78,8
213490,1791,382,70,75,5
164853,1310,392,70,70,0
236530,1820,395,70,78,8
237554,1612,355,70,75,5
178418,1677,355,70,70,0
252146,1726,380,70,77,7
225779,1786,365,70,79,9
230387,1606,328,70,70,0
241651,1706,370,70,77,7
246771,1838,389,70,71,1
193267,1578,337,70,70,0
205556,1636,351,70,71,1
148212,1126,376,70,70,0
163828,1799,369,70,70,0
234740,1797,385,70,76,6
237156,1787,382,70,79,9
242336,1775,367,70,75,5
235123,1777,379,70,75,5
185199,1695,354,70,70,0
199282,1788,365,70,70,0
236145,1838,391,70,70,0
221553,1669,349,70,70,0
211057,1872,400,70,70,0
209521,1744,375,70,70,0
199537,1916,399,70,70,0
237424,1820,389,70,76,6
226928,1879,389,70,70,0
229487,1739,396,70,74,4
171378,1917,402,70,70,0
224367,1477,316,70,70,0
253294,1671,377,70,73,3
243821,1705,367,70,70,0
190058,1845,376,70,70,0
187498,1799,373,70,70,0
237670,1859,387,70,75,5
245354,1825,394,70,79,9
232810,1753,374,70,72,2
163186,1948,397,70,70,0
215155,1929,405,70,70,0
190589,1942,408,70,70,0
241536,1778,382,70,73,3
241790,1057,385,70,72,2
177790,1727,368,70,70,0
183422,1965,403,70,70,0
258942,1723,374,70,85,15
212095,1626,343,70,70,0
214911,1883,406,70,70,0
235135,1731,380,70,73,3
221312,1630,356,70,73,3
200065,1531,328,70,72,2
231027,1829,373,70,70,0
258433,1885,408,70,81,11
216706,1937,404,70,70,0
223618,1877,393,70,73,3
164994,1894,383,70,70,0
237442,1663,362,70,71,1
242818,1149,393,70,80,10
204163,1702,369,70,71,1
236147,1784,381,70,70,0
231530,1813,388,70,71,1
225386,1504,325,70,72,2
210538,1930,392,70,70,0
248698,1581,346,70,80,10
236668,1792,379,70,75,5
209532,1206,383,70,73,3
194171,1882,387,70,70,0
181371,1922,399,70,70,0
224891,1795,397,70,73,3
208507,1229,397,70,70,0
259962,1597,339,70,75,5
192634,1940,404,70,70,0
173434,1831,388,70,70,0
201066,1926,395,70,70,0
235642,1804,394,70,78,8
230522,1770,373,70,70,0
230266,1837,380,70,70,0
255353,1823,400,70,71,1
222585,1620,350,70,70,0
215417,1147,387,70,70,0
224376,1493,313,70,74,4
218744,1903,404,70,71,1
248188,1753,379,70,81,11
258685,1738,368,70,79,9
194662,1741,365,70,70,0
235623,1808,391,70,71,1
236649,1162,388,70,77,7
230249,1662,356,70,70,0
222825,1713,372,70,70,0
244584,1035,373,70,72,2
214376,1715,383,70,70,0
204136,1872,378,70,70,0
219755,1924,403,70,70,0
247148,1452,316,70,70,0
209005,1589,356,70,70,0
173671,1468,316,70,70,0
229991,1760,365,70,74,4
233520,1764,367,69,71,2
259119,1599,352,69,81,12
248878,1544,342,69,76,7
258350,1652,366,69,74,5
202799,1706,357,69,70,1
204847,1745,377,69,69,0
209711,1434,306,69,69,0
217646,1287,390,69,69,0
184624,1670,346,69,69,0
205351,1831,370,69,69,0
204846,1090,367,69,72,3
260644,1625,356,69,82,13
252060,1868,398,69,80,11
245148,1703,360,69,69,0
225692,1655,356,69,74,5
204956,1775,386,69,69,0
186267,1846,392,69,69,0
243867,1544,326,69,69,0
227995,1904,394,69,76,7
188058,1668,356,69,69,0
183706,1823,376,69,69,0
205210,1865,384,69,69,0
193945,1817,392,69,69,0
183449,1952,402,69,69,0
235673,1560,327,69,77,8
164505,1184,385,69,69,0
260248,1736,358,69,69,0
243608,1789,396,69,79,10
231320,1654,353,69,78,9
209304,1632,352,69,69,0
208024,1568,344,69,69,0
229271,1719,368,69,72,3
210583,1889,381,69,72,3
218013,1781,391,69,69,0
198437,1715,364,69,69,0
138798,1202,378,69,69,0
209701,1791,371,69,70,1
198190,1811,390,69,69,0
255533,1827,391,69,78,9
245293,1818,393,69,69,0
224045,1653,347,69,74,5
207916,1875,407,69,70,1
183339,1928,413,69,69,0
255529,1634,354,69,80,11
242217,1875,405,69,77,8
216105,1799,384,69,73,4
244264,1908,410,69,75,6
240168,1668,350,69,69,0
236072,1788,368,69,69,0
211240,1768,376,69,69,0
246055,1778,398,69,75,6
230439,1864,385,69,69,0
214567,1579,348,69,69,0
224049,1762,382,69,72,3
202535,1708,368,69,69,0
236838,1905,405,69,78,9
227622,1771,369,69,73,4
213030,1753,364,69,69,0
223793,1859,389,69,69,0
239816,994,375,69,78,9
231985,1838,387,69,69,0
242527,1546,339,69,78,9
221793,1719,365,69,69,0
221281,1561,333,69,74,5
188768,1816,377,69,69,0
240992,1952,407,69,71,2
237152,1730,375,69,73,4
221024,1637,356,69,71,2
208480,1949,411,69,70,1
204895,1771,382,69,69,0
253281,1719,374,69,75,6
254814,1668,371,69,76,7
243806,1704,369,69,69,0
212830,1719,371,69,70,1
209758,1650,353,69,70,1
190557,1988,405,69,69,0
245341,1797,385,69,79,10
233565,1628,362,69,76,7
233825,1694,368,69,72,3
199266,1838,379,69,69,0
248113,1726,373,69,78,9
254310,1669,358,69,82,13
190311,1723,374,69,69,0
184167,1216,386,69,69,0
240743,1691,365,69,70,1
165735,1163,393,69,69,0
218471,1961,413,69,69,0
261478,1723,373,69,79,10
254822,1918,417,69,70,1
253030,1848,392,69,80,11
223074,1751,365,69,72,3
186982,1969,406,69,69,0
244582,1814,381,69,69,0
239717,1747,374,69,69,0
250723,1839,401,69,82,13
245347,1468,309,69,77,8
211299,1152,388,69,69,0
237410,1772,398,69,72,3
223581,1772,374,69,69,0
156253,1250,398,69,69,0
198749,1881,399,69,69,0
235827,1845,394,69,69,0
208437,1907,392,69,69,0
201013,1656,346,69,69,0
190772,1705,364,69,69,0
230196,1660,355,69,69,0
210484,1920,401,69,70,1
204084,1805,386,69,69,0
242995,1753,381,69,69,0
199574,1053,374,69,70,1
258908,1666,352,69,79,10
223283,1614,345,69,69,0
214323,1722,377,69,69,0
210739,1936,409,69,70,1
189234,1952,401,69,69,0
253234,1780,358,69,69,0
205618,1714,362,69,71,2
190769,1109,368,69,69,0
243253,1794,384,69,77,8
248117,1869,386,69,77,8
214326,1521,326,69,69,0
223030,1930,408,69,70,1
245084,1768,384,69,75,6
230747,1786,397,69,72,3
228699,1582,342,69,74,5
216155,1667,376,69,70,1
189530,1845,387,69,69,0
241498,1758,384,69,69,0
230490,1852,385,69,69,0
229466,1827,391,69,69,0
246617,1955,405,69,78,9
230489,1704,360,69,69,0
229209,1723,386,69,69,0
210521,1635,361,69,69,0
198489,1956,408,69,69,0
236599,1805,389,69,79,10
171574,1182,385,69,69,0
233366,1836,401,69,69,0
240526,1699,365,69,69,0
253077,1791,388,69,69,0
220847,1885,407,69,71,2
232894,1545,335,69,71,2
176062,1833,374,69,69,0
243390,1560,357,69,80,11
188094,1293,399,69,69,0
255934,1810,386,69,78,9
205759,1082,371,69,70,1
215487,1696,372,69,73,4
229294,1424,315,69,69,0
183743,1150,394,69,69,0
222382,1821,394,69,74,5
214957,1705,356,69,69,0
202157,1931,407,69,69,0
185260,1777,363,69,69,0
234924,1681,365,69,72,3
246443,1530,332,69,69,0
232107,1070,371,69,74,5
231614,1782,395,69,74,5
230334,1766,375,69,69,0
214718,1763,384,69,69,0
213694,1717,373,69,69,0
246192,1843,393,69,80,11
244656,982,361,69,72,3
254895,1563,328,69,69,0
243887,1842,402,69,70,1
242351,1895,392,69,69,0
232879,1843,381,69,69,0
232623,1859,400,69,73,4
213948,1793,376,69,69,0
223676,1880,400,69,69,0
234172,1739,393,69,69,0
246716,1756,382,69,72,3
257980,1727,370,69,78,9
199101,1164,386,69,69,0
206269,1836,385,69,69,0
213693,1863,404,69,72,3
239807,1925,409,69,80,11
252095,1573,334,69,79,10
237745,1771,379,69,69,0
239814,1544,348,69,74,5
202693,1827,404,69,70,1
234949,1769,379,69,69,0
236997,1786,387,69,74,5
197062,1769,375,69,69,0
211398,1060,381,69,72,3
215750,1729,364,69,69,0
229574,1609,346,69,73,4
214727,1835,389,69,70,1
188607,1920,408,69,69,0
223175,973,372,69,72,3
229831,1696,369,69,74,5
239303,1702,377,69,70,1
246471,1630,352,69,79,10
255943,1748,374,69,76,7
206536,1843,400,69,69,0
229064,1784,392,69,74,5
244932,1772,377,69,79,10
232900,1680,365,69,69,0
216260,1837,401,69,69,0
254659,1835,390,69,76,7
206272,1237,389,69,69,0
214208,1774,370,69,69,0
234688,1753,373,69,72,3
243392,1699,371,69,82,13
193728,1861,398,69,69,0
234945,1769,368,69,74,5
236993,1856,405,69,71,2
239041,1799,382,69,72,3
251585,1541,342,69,69,0
253377,1575,343,69,77,8
255169,1597,339,69,69,0
250818,1693,366,69,78,9
213699,1586,351,69,73,4
18115,1728,361,69,69,0
239043,1714,370,69,74,5
214193,1685,373,69,69,0
240561,1761,371,69,76,7
184469,1919,398,69,69,0
244110,1796,390,69,69,0
236944,1661,351,69,72,3
262800,1583,353,69,73,4
238223,1083,376,69,73,4
235151,1825,392,69,69,0
234383,1115,375,69,76,7
233871,1930,410,69,69,0
231823,1566,334,69,76,7
244840,1781,389,69,76,7
261306,1772,379,69,78,9
234894,1899,399,69,79,10
248205,1818,392,69,77,8
220045,1657,360,69,74,5
194956,1887,392,69,69,0
245900,1497,328,69,81,12
230027,1890,398,69,70,1
244667,1812,384,69,69,0
213905,1772,378,69,71,2
232849,1832,399,69,74,5
248209,1621,360,69,78,9
193425,1912,402,69,69,0
237461,1715,366,69,70,1
235925,1162,382,69,74,5
234901,1640,356,69,75,6
220821,1584,358,69,73,4
206485,1649,344,69,69,0
192660,1672,365,69,69,0
247188,1742,370,69,70,1
244884,1755,381,69,79,10
232852,1799,386,69,69,0
231828,1429,310,69,69,0
227732,1704,364,69,72,3
139668,1215,384,69,69,0
241811,1855,389,69,78,9
257170,1451,316,69,79,10
223122,1526,329,69,69,0
205243,1424,302,69,69,0
241850,1625,351,69,77,8
241073,1673,370,69,75,6
189619,1856,397,69,69,0
250805,1619,356,69,73,4
209333,1130,384,69,69,0
256692,1832,394,69,72,3
183220,1804,362,69,69,0
239028,1827,397,69,76,7
233140,1933,418,69,69,0
222900,1272,389,69,71,2
183475,1188,387,69,69,0
237754,1489,319,69,71,2
244147,1779,389,69,72,3
203699,1758,362,69,69,0
262579,1671,353,69,81,12
243378,1694,363,69,75,6
232626,1635,358,69,69,0
214194,1723,369,69,70,1
241585,1574,344,69,78,9
225206,1896,413,69,69,0
243894,1891,400,69,70,1
215735,1770,376,69,69,0
227511,1627,350,69,76,7
236474,1759,389,69,73,4
233146,1833,397,69,69,0
229818,1585,348,69,73,4
218298,1114,373,69,70,1
202170,1691,360,69,69,0
186553,1886,402,69,69,0
180409,1694,361,69,69,0
240057,1800,379,69,69,0
227513,1799,394,69,73,4
213433,1531,331,69,69,0
262585,1648,364,69,84,15
233400,1703,369,69,72,3
215480,1709,369,69,71,2
244407,1814,397,69,79,10
234679,1734,368,69,77,8
228456,1087,372,69,75,6
230713,1875,414,69,72,3
220521,1771,370,69,71,2
257784,1816,386,69,83,14
235507,1742,376,69,72,3
220915,1746,368,69,73,4
230386,1652,353,69,69,0
195313,1503,320,69,69,0
218353,1665,359,69,69,0
200433,1786,378,69,69,0
199665,1823,375,69,69,0
198641,1559,347,69,69,0
238576,1464,319,69,77,8
173040,1748,375,69,69,0
258287,1641,354,69,77,8
189167,1840,380,69,69,0
238319,1748,380,69,77,8
201967,1749,378,69,69,0
152814,1713,352,69,69,0
188397,1835,377,69,69,0
252317,1473,320,69,76,7
198046,1871,399,69,69,0
202910,1127,374,69,69,0
204276,1712,347,69,69,0
248564,1692,371,69,79,10
251380,1667,370,69,76,7
216055,1853,395,69,69,0
239608,1712,370,69,74,5
228600,1772,386,69,74,5
260599,1735,377,69,83,14
247031,1427,324,69,78,9
238839,1895,401,69,71,2
235511,1885,403,69,69,0
233975,1029,353,69,69,0
223223,1958,404,69,69,0
205559,1783,386,69,69,0
188916,1664,371,69,69,0
199159,1915,395,69,69,0
252150,1838,382,69,77,8
242166,1671,373,69,69,0
239350,1735,377,69,74,5
223734,1558,333,69,69,0
244213,1718,368,69,69,0
236533,1558,342,69,70,1
231413,920,363,69,75,6
237214,1519,331,69,71,2
176542,1760,373,69,69,0
184990,1891,400,69,69,0
183973,1696,351,69,69,0
226468,1504,328,69,76,7
234660,1789,393,69,72,3
234916,1764,377,69,72,3
238756,1650,356,69,79,10
252580,1728,379,69,78,9
233125,1775,369,69,72,3
245157,1816,390,69,70,1
246949,1682,362,69,75,6
208806,1679,363,69,69,0
247203,1759,390,69,69,0
229286,1726,376,69,72,3
242342,1843,391,69,76,7
246182,1666,359,69,73,4
255654,1691,360,69,82,13
201895,1800,381,69,72,3
238503,905,356,69,73,4
239271,1010,364,69,70,1
191655,1166,377,69,69,0
202148,1912,404,69,69,0
177571,1581,328,69,69,0
252830,1687,358,69,74,5
222881,1846,385,69,71,2
256158,1694,362,69,78,9
203423,1172,373,69,69,0
221855,1792,385,69,69,0
186783,1818,390,69,69,0
211872,1901,400,69,69,0
246688,1731,379,69,77,8
247968,1744,382,69,69,0
219553,1791,380,69,69,0
223137,1615,347,69,76,7
211363,1658,361,69,73,4
225441,1791,378,69,74,5
231841,1010,376,69,74,5
238497,1768,382,69,72,3
240801,1662,358,69,71,2
242081,1772,381,69,79,10
201890,1757,376,69,69,0
253602,1610,350,69,74,5
256674,1698,365,69,76,7
255736,1793,387,69,75,6
196857,1703,369,69,69,0
48745,1693,338,69,69,0
225273,1856,399,69,73,4
164559,1762,348,69,69,0
236752,1726,375,69,72,3
244176,1686,360,69,73,4
201938,1855,390,69,69,0
140498,1149,389,69,69,0
239571,1780,388,69,75,6
245715,1793,396,69,79,10
181971,1902,401,69,69,0
250835,1741,387,69,74,5
253139,1864,403,69,79,10
255699,1716,380,69,75,6
230356,1871,395,69,69,0
251348,1766,383,69,69,0
251604,1709,368,69,74,5
262869,1475,319,69,76,7
208597,1504,321,69,71,2
222165,1687,361,69,76,7
224213,1714,381,69,72,3
242389,1702,354,69,74,5
224975,1488,325,69,69,0
209359,1956,401,69,70,1
251342,1688,366,69,76,7
203979,1889,392,69,69,0
224201,1650,356,69,72,3
176841,1758,362,69,69,0
243657,1810,390,69,84,15
252873,1763,392,69,76,7
214730,1134,385,69,69,0
219594,1798,372,69,72,3
222154,1662,353,69,72,3
259786,1682,376,69,75,6
192715,1479,331,69,69,0
180174,1822,397,69,69,0
261579,1625,364,69,75,6
210380,1784,376,69,69,0
230092,1760,381,69,73,4
252108,1799,383,69,83,14
237005,1768,386,69,72,3
184781,1034,379,69,69,0
259789,1764,382,69,79,10
243918,1779,380,69,78,9
210646,1818,388,69,70,1
231638,1789,375,69,74,5
212439,1487,333,69,69,0
251387,1729,378,69,78,9
241150,1831,397,69,79,10
246013,1835,388,69,69,0
232189,1537,340,69,78,9
225533,1666,367,69,74,5
223229,1790,383,69,74,5
218621,1835,401,69,69,0
230396,1764,378,69,69,0
203004,1133,379,69,70,1
167931,1145,386,69,69,0
255742,1868,400,69,74,5
232699,1583,343,69,70,1
227835,1807,384,69,73,4
242426,1729,378,69,75,6
235770,1797,385,69,75,6
221434,1867,387,69,69,0
203002,1707,360,69,69,0
262394,1680,365,69,79,10
243449,1508,324,69,74,5
246014,1820,391,69,75,6
257278,1586,362,69,80,11
230871,1673,361,69,72,3
229594,1777,370,69,74,5
232919,1804,384,69,69,0
258775,1836,392,69,83,14
203224,1579,337,69,69,0
152536,1933,391,69,69,0
204761,1553,331,69,69,0
206553,1607,352,69,69,0
253913,1754,368,69,69,0
223962,1771,396,69,75,6
255450,1716,376,69,72,3
195838,1751,377,69,69,0
197851,1284,390,69,69,0
232861,1736,368,69,69,0
244381,1507,330,69,70,1
236744,1595,353,69,78,9
232136,1478,326,69,73,4
253951,1567,336,69,74,5
218623,1931,413,69,69,0
183453,1907,403,69,69,0
257191,1735,385,69,77,8
259751,1622,348,69,81,12
224424,1891,397,69,73,4
230824,1769,378,69,77,8
258632,1771,381,69,74,5
149064,1799,370,69,69,0
202056,1722,368,69,69,0
192071,1690,367,69,69,0
247623,1581,347,69,81,12
239431,1602,347,69,69,0
237895,1831,383,69,72,3
221767,1670,349,69,70,1
214343,1717,374,69,69,0
211783,1657,350,69,70,1
208455,1789,391,69,69,0
220230,1416,308,69,74,5
211270,1447,313,69,69,0
204102,1949,408,69,70,1
194885,1816,380,69,69,0
236613,990,378,69,76,7
219461,1581,341,69,77,8
193092,1789,380,69,69,0
199748,1773,375,69,69,0
230473,1736,359,69,69,0
242249,1796,386,69,83,14
205386,1108,383,69,72,3
189003,1857,385,69,69,0
222286,1533,326,69,72,3
215374,1632,355,69,69,0
214606,1753,380,69,69,0
208462,1715,356,69,70,1
213325,1762,364,69,69,0
211021,1161,388,69,73,4
209997,1557,338,69,69,0
257868,1854,404,69,82,13
182091,1803,392,69,69,0
215370,1654,343,69,71,2
157515,1860,388,69,69,0
219979,1734,377,69,73,4
214603,1870,391,69,69,0
202827,1913,394,69,69,0
198731,1760,383,69,69,0
189514,1914,402,69,69,0
173130,1924,401,69,69,0
224330,1852,391,69,71,2
184643,1853,395,69,69,0
224067,1630,353,69,70,1
193602,1597,333,69,69,0
238137,1777,391,69,69,0
229436,1634,349,69,74,5
226108,1539,325,69,76,7
241467,1636,358,69,76,7
224315,1826,393,69,69,0
184890,1815,382,69,69,0
194361,1803,383,69,69,0
251193,1613,349,69,74,5
242489,1667,363,69,72,3
233785,1503,327,69,73,4
200765,1843,386,69,69,0
260040,1777,390,69,79,10
216633,1151,382,69,69,0
216376,1881,399,69,69,0
240439,1573,335,69,76,7
238647,1842,405,69,70,1
239211,1548,340,69,72,3
241002,1770,382,69,76,7
230506,1675,349,69,72,3
251196,1773,386,69,69,0
149309,1059,352,69,69,0
243778,979,371,69,76,7
246335,1783,379,69,81,12
239170,1917,397,69,69,0
232770,1848,390,69,74,5
231489,1017,372,69,69,0
222273,1879,399,69,69,0
192320,1963,397,69,69,0
242752,1610,354,69,77,8
241728,1512,326,69,69,0
209984,1728,373,69,70,1
231743,1687,372,69,75,6
225853,1912,415,69,73,4
220479,1859,392,69,69,0
233790,1643,365,69,72,3
215358,1910,409,69,69,0
204350,1756,367,69,69,0
185405,1086,378,69,69,0
242749,1839,396,69,79,10
230205,1839,385,69,69,0
229949,1765,392,69,69,0
228174,1506,329,69,78,9
182862,1847,380,69,69,0
239439,1729,382,69,77,8
193027,1660,360,69,69,0
189701,1751,362,69,69,0
176389,1079,395,69,69,0
239364,993,364,69,75,6
232452,1711,379,69,69,0
231428,1907,403,69,72,3
216580,1843,390,69,70,1
203780,1724,371,69,69,0
258563,1863,397,69,75,6
190979,1869,386,69,70,1
198150,1812,374,69,69,0
250883,1705,359,69,75,6
232195,1761,387,69,69,0
206083,1681,364,69,70,1
259586,1883,398,69,83,14
252930,1745,377,69,80,11
245762,1803,384,69,78,9
210434,1748,380,69,69,0
198914,1925,408,69,69,0
256261,1673,360,69,81,12
207622,1672,352,69,70,1
229889,1639,361,69,70,1
232713,1109,377,69,74,5
242088,1760,372,69,72,3
238505,1695,363,69,80,11
223402,1891,401,69,71,2
230314,1147,380,69,69,0
252074,1490,326,69,76,7
223147,1783,377,69,69,0
179899,1879,388,69,69,0
246459,1675,369,69,82,13
206601,1697,365,69,69,0
241670,1797,382,69,69,0
188168,1797,379,69,69,0
245768,1574,350,69,70,1
223240,1667,361,69,69,0
189447,1707,362,69,69,0
241927,1931,406,69,76,7
232711,1923,414,69,73,4
225543,1139,380,69,74,5
212231,1509,334,69,70,1
255233,1735,370,69,83,14
251392,1873,402,69,79,10
189263,1718,361,69,69,0
227921,1862,397,69,69,0
242002,1835,400,69,70,1
241746,1708,371,69,71,2
238674,927,341,69,74,5
232786,1741,372,69,74,5
230226,1874,410,69,69,0
207954,1720,361,69,69,0
243793,1776,370,69,74,5
235089,1528,336,69,69,0
199761,1760,380,69,69,0
258898,1690,366,69,83,14
252240,1869,386,69,76,7
245840,1862,391,69,69,0
244560,1686,371,69,80,11
242768,1755,376,69,73,4
234576,1528,336,69,79,10
224336,1887,393,69,69,0
212048,1923,403,69,69,0
196688,1730,369,69,69,0
245586,1784,378,69,77,8
260178,1578,336,69,77,8
233472,1649,351,69,72,3
229207,1855,389,69,74,5
232192,1754,379,69,75,6
230912,1769,389,69,75,6
214784,1721,379,69,69,0
210688,1968,422,69,72,3
197376,1783,373,69,69,0
235799,1816,398,69,75,6
243544,1852,393,69,77,8
224344,1651,347,69,69,0
206167,1856,384,69,69,0
231507,1812,391,69,69,0
197975,1845,393,69,69,0
219990,1880,398,69,73,4
214358,1849,396,69,69,0
244309,1955,409,69,70,1
225877,1146,381,69,69,0
186452,1917,384,69,69,0
162900,1908,383,69,69,0
219988,1727,368,69,69,0
212735,1121,384,69,74,5
257558,1863,390,69,69,0
225812,1822,382,69,73,4
229923,1696,372,69,72,3
193569,1611,348,69,69,0
211746,1832,380,69,69,0
215074,1902,405,69,69,0
230178,1750,372,69,69,0
194082,1800,374,69,69,0
205347,1881,400,69,69,0
210723,1861,386,69,69,0
163619,1926,411,69,69,0
257827,925,353,69,79,10
219670,1884,401,69,72,3
200228,1390,290,69,69,0
210724,1923,406,69,71,2
225572,1726,385,69,70,1
232228,1596,336,69,74,5
234020,1623,345,69,69,0
247076,1817,384,69,73,4
239323,1594,354,69,74,5
204763,1893,394,69,69,0
239393,1842,388,69,69,0
234017,1756,361,69,69,0
211745,1756,356,69,69,0
205857,1540,342,69,69,0
206317,1736,373,69,69,0
228589,1889,390,69,72,3
252397,1719,361,69,70,1
237340,1730,385,69,70,1
246044,1733,372,69,80,11
234781,1516,324,69,70,1
108061,1866,386,69,69,0
251421,1664,370,69,82,13
253213,1726,378,69,74,5
208158,1745,372,69,70,1
225310,1888,406,69,72,3
242974,1869,397,69,76,7
258590,1708,368,69,72,3
202271,1752,362,69,69,0
232991,1876,407,69,69,0
248095,1800,393,69,69,0
222240,1918,401,69,69,0
250902,1695,364,69,69,0
214038,1537,340,69,72,3
252014,1816,399,69,70,1
205584,1595,353,69,69,0
262417,1010,368,69,77,8
196881,1597,343,69,69,0
246800,1762,399,69,77,8
215266,1720,378,69,69,0
242448,1725,365,69,75,6
241168,1727,363,69,78,9
236304,1629,339,69,76,7
235536,1811,388,69,78,9
251243,1677,351,69,80,11
187157,1700,345,69,69,0
197996,1880,392,69,69,0
204652,1920,405,69,69,0
226668,1711,359,69,69,0
226157,1816,397,69,72,3
228205,1596,345,69,69,0
230253,1688,363,69,69,0
235629,1034,385,69,74,5
202350,1835,374,69,69,0
264465,1808,379,69,69,0
222225,1812,385,69,69,0
229905,1536,325,69,70,1
203026,1770,384,69,69,0
243477,1595,338,69,78,9
237077,1776,380,69,75,6
191252,1886,408,69,69,0
184084,1092,392,69,69,0
235028,1626,345,69,77,8
230164,1092,377,69,69,0
205588,1555,327,69,69,0
189715,1992,412,69,69,0
179731,1882,393,69,69,0
237331,1714,373,69,77,8
237075,1681,358,69,69,0
202771,1878,398,69,69,0
184338,1725,364,69,69,0
234002,1806,374,69,69,0
215570,1623,356,69,72,3
213778,1734,372,69,69,0
213010,1834,397,69,69,0
242412,1542,332,69,74,5
213228,1921,406,69,70,1
235755,1653,368,69,76,7
202778,1058,365,69,69,0
237339,1671,371,69,72,3
221467,1894,395,69,69,0
215067,1675,356,69,71,2
201243,1506,327,69,69,0
183578,1467,319,69,69,0
242714,1643,364,69,72,3
242458,1587,349,69,75,6
215066,1929,413,69,69,0
261145,1757,382,69,77,8
234987,1901,407,69,76,7
193561,1879,399,69,69,0
240409,1581,342,69,70,1
239641,1831,397,69,75,6
232985,1864,400,69,76,7
200473,1821,381,69,69,0
255256,1782,385,69,76,7
241176,1851,388,69,75,6
232728,1852,389,69,69,0
190491,1708,366,69,70,1
257307,1730,372,69,78,9
243675,1034,382,69,81,12
234716,1708,370,69,72,3
231137,1678,368,69,71,2
198625,1340,404,69,69,0
198113,1885,376,69,69,0
202208,1894,408,69,69,0
194015,1766,367,69,69,0
259295,1003,357,69,69,0
258271,1682,361,69,80,11
238559,1563,341,69,70,1
236255,1648,353,69,78,9
235999,1250,392,69,77,8
220895,1897,397,69,70,1
227806,1843,381,69,74,5
220638,1648,354,69,69,0
217054,1559,337,69,70,1
201438,1894,380,69,69,0
234717,1132,389,69,69,0
223709,1175,385,69,69,0
142616,1118,386,69,69,0
203544,1900,387,69,69,0
248075,1818,396,69,72,3
218343,1709,377,69,70,1
198632,1768,383,69,69,0
200424,1912,397,69,69,0
230376,1848,386,69,69,0
233960,1614,359,69,75,6
248808,1755,372,69,82,13
200425,1717,363,69,69,0
222697,1763,377,69,69,0
224489,1513,330,69,76,7
226793,1713,368,69,69,0
236265,1671,358,69,70,1
177129,1784,368,69,69,0
153066,1931,397,69,69,0
230378,1716,355,69,69,0
189930,1934,407,69,69,0
198635,1761,369,69,69,0
201707,1675,357,69,69,0
220395,1697,370,69,72,3
252903,1657,353,69,79,10
239846,1086,371,69,70,1
244491,1559,346,69,74,5
231910,1703,382,69,72,3
241931,1833,395,69,74,5
241419,1769,382,69,77,8
212747,1797,368,69,70,1
204043,1801,385,69,69,0
247050,1726,363,69,77,8
49674,1734,354,69,69,0
252937,1728,368,69,77,8
261143,1938,405,69,84,15
220386,1726,379,69,74,5
232162,1754,385,69,70,1
243170,1622,352,69,74,5
197860,1814,391,69,69,0
210404,1686,370,69,69,0
222692,1800,375,69,72,3
236260,1845,391,69,69,0
211173,1639,345,69,70,1
217061,1564,331,69,69,0
213102,1795,381,69,69,0
245520,1818,398,69,71,2
252270,1867,396,69,75,6
241032,1857,397,69,72,3
246657,975,370,69,76,7
236673,1701,359,69,78,9
217217,1746,366,69,69,0
203137,1507,331,69,69,0
202113,1841,402,69,69,0
200577,1849,389,69,69,0
258432,1491,331,69,81,12
190592,1433,309,69,69,0
189824,1642,344,69,69,0
232832,1864,400,69,74,5
215168,1657,354,69,69,0
177279,1944,404,69,69,0
222079,1853,401,69,76,7
247678,1694,372,69,80,11
230526,1832,382,69,69,0
223358,1534,345,69,72,3
247933,1694,381,69,81,12
211325,1925,404,69,69,0
238460,1665,358,69,80,11
194945,1816,380,69,69,0
214658,1870,398,69,72,3
226434,1521,327,69,69,0
253061,1686,360,69,82,13
209800,1474,310,69,69,0
252551,1685,368,69,80,11
243591,1720,371,69,69,0
232839,1810,390,69,76,7
257414,1656,358,69,69,0
246918,1763,376,69,78,9
203398,1702,373,69,70,1
258949,1743,380,69,81,12
187013,1781,354,69,69,0
233090,1729,372,69,74,5
231301,1752,370,69,73,4
188271,1802,384,69,69,0
208005,1729,372,69,69,0
204677,1747,360,69,69,0
205188,1705,362,69,69,0
234627,1582,341,69,78,9
203139,1502,323,69,70,1
243586,1722,360,69,69,0
189207,1759,360,69,69,0
260720,1631,345,69,72,3
201841,1528,312,69,70,1
241273,1636,364,69,74,5
232823,1894,415,69,72,3
233591,1759,387,69,69,0
241783,1720,365,69,75,6
259191,1784,376,69,75,6
197240,1797,378,69,69,0
263032,1044,389,69,76,7
230520,1669,346,69,69,0
254840,1583,360,69,80,11
242041,1823,393,69,74,5
226167,1785,389,69,72,3
253305,1663,357,69,70,1
214906,1726,364,69,69,0
224890,1684,371,69,69,0
225402,1878,401,69,69,0
232826,1784,381,69,74,5
242554,1817,396,69,72,3
244602,1767,373,69,78,9
188538,1449,307,69,69,0
164471,1665,332,69,69,0
218743,1736,370,69,71,2
240241,1890,400,69,78,9
189300,1758,385,69,69,0
180337,1089,390,69,69,0
214386,1773,375,69,69,0
235890,1753,375,69,70,1
192370,1803,373,69,69,0
199283,1945,406,69,69,0
246387,1761,377,69,73,4
215412,1745,370,69,71,2
242036,1851,394,69,70,1
198261,1782,375,69,69,0
215927,1689,340,69,69,0
199285,1853,379,69,69,0
236405,1770,374,69,70,1
262262,1270,387,69,80,11
197238,1667,347,69,69,0
219510,1904,397,69,69,0
164470,1831,373,69,69,0
230774,1521,339,69,76,7
53110,1174,375,69,69,0
224648,1821,387,69,69,0
212613,1733,367,69,71,2
215177,1905,406,69,69,0
231949,1861,385,69,69,0
246139,1036,377,69,80,11
237179,1665,371,69,74,5
225915,1669,360,69,74,5
218747,1770,378,69,69,0
211323,1695,352,69,73,4
263291,1620,359,69,78,9
237580,975,364,69,70,1
256780,1669,355,69,83,14
262413,1650,358,69,75,6
262925,1886,404,69,79,10
220429,1633,354,69,69,0
220685,1787,370,69,69,0
256781,1703,372,69,85,16
234108,1729,371,69,79,10
211982,1768,385,69,70,1
219918,1102,382,69,69,0
232462,1889,406,69,69,0
237582,1864,397,69,71,2
238862,1465,313,69,72,3
209423,1116,387,69,70,1
235279,1768,381,69,69,0
183567,1203,378,69,69,0
237936,1793,393,69,78,9
229488,1858,393,69,69,0
221552,1801,380,69,69,0
212592,1852,400,69,69,0
224137,1681,366,69,69,0
202978,1680,361,69,69,0
236924,1490,319,69,77,8
198538,1796,376,69,69,0
236938,1660,368,69,77,8
173450,1743,384,69,69,0
258698,1758,370,69,82,13
199051,1626,345,69,69,0
211595,1849,386,69,72,3
225931,1860,388,69,75,6
145996,1761,364,68,68,0
177482,1864,377,68,68,0
186954,1760,371,68,68,0
243275,1490,322,68,81,13
184139,1119,379,68,68,0
198220,1804,380,68,68,0
264268,1515,325,68,77,9
230221,1691,351,68,68,0
225868,1204,384,68,70,2
243788,1790,376,68,75,7
224842,1915,406,68,73,5
208714,1735,360,68,68,0
234829,1717,370,68,68,0
176717,1560,328,68,68,0
223566,1782,374,68,71,3
228682,1583,347,68,75,7
207943,1883,388,68,68,0
211786,1710,360,68,68,0
233282,1119,361,68,70,2
224403,1789,384,68,68,0
225939,1720,373,68,68,0
235103,1759,383,68,70,2
255839,1599,347,68,79,11
234134,1781,380,68,71,3
214594,1830,381,68,68,0
235842,1579,329,68,75,7
237380,1772,383,68,69,1
246594,1796,382,68,81,13
230467,1693,354,68,68,0
255043,1521,342,68,80,12
258371,1745,386,68,76,8
184900,1635,337,68,68,0
202052,1712,366,68,68,0
240964,1789,382,68,72,4
252484,1879,397,68,72,4
242503,1834,398,68,75,7
254281,1722,369,68,74,6
250959,1814,380,68,79,11
246351,1805,396,68,79,11
239951,1764,379,68,71,3
217167,1803,379,68,71,3
198479,1411,300,68,68,0
49486,1746,362,68,68,0
253766,1716,373,68,78,10
202570,1146,381,68,68,0
241737,1798,392,68,76,8
213061,1827,386,68,68,0
240201,1865,395,68,77,9
209737,1804,368,68,68,0
200521,1702,363,68,68,0
262473,1694,373,68,77,9
195912,1712,358,68,68,0
187208,1209,379,68,68,0
206408,1577,326,68,68,0
254023,1799,390,68,74,6
252495,1710,382,68,83,15
193359,1105,369,68,68,0
219216,1826,387,68,69,1
239696,1683,354,68,76,8
263238,998,367,68,73,5
238662,1839,413,68,76,8
237203,1830,392,68,77,9
241043,1753,377,68,68,0
235156,1527,330,68,73,5
236692,1616,351,68,72,4
240020,1675,359,68,77,9
242324,1770,379,68,68,0
223637,1797,393,68,68,0
224149,1728,367,68,72,4
240277,1519,321,68,81,13
244117,1505,320,68,68,0
252053,1551,339,68,75,7
240454,1727,372,68,71,3
222358,1665,357,68,68,0
253008,1687,365,68,77,9
247888,1795,375,68,85,17
189077,1780,377,68,68,0
201815,1681,366,68,68,0
258654,1682,361,68,75,7
231212,1800,375,68,72,4
243244,1650,356,68,71,3
211245,1926,408,68,71,3
239405,1851,392,68,74,6
174381,1779,369,68,68,0
255021,1716,382,68,71,3
224302,1544,327,68,73,5
227630,1693,366,68,74,6
231726,1805,385,68,74,6
236846,1874,395,68,77,9
240942,1749,373,68,76,8
247086,1829,394,68,71,3
247854,1766,382,68,77,9
121134,1189,378,68,68,0
215343,1180,381,68,71,3
240943,1716,375,68,68,0
176687,1786,373,68,68,0
192559,1486,320,68,68,0
264240,1735,369,68,85,17
208432,1658,351,68,68,0
219952,1825,385,68,72,4
225072,1634,361,68,75,7
234284,1741,377,68,68,0
209196,1549,343,68,70,2
197681,1784,390,68,68,0
203308,1839,387,68,69,1
232479,1717,375,68,72,4
228639,1639,356,68,75,7
257566,1620,346,68,81,13
228894,1732,377,68,70,2
209950,1698,371,68,68,0
260637,1641,354,68,78,10
172317,1691,353,68,68,0
262429,1505,343,68,72,4
212764,1723,364,68,68,0
238619,1712,366,68,69,1
236571,1026,366,68,77,9
229147,1842,392,68,72,4
211739,1631,354,68,68,0
242202,1643,350,68,73,5
210202,1791,383,68,68,0
194329,1922,398,68,68,0
255257,1666,349,68,84,16
238873,1571,341,68,78,10
211243,1813,370,68,68,0
215083,1879,399,68,68,0
248107,1774,386,68,76,8
246832,1667,356,68,73,5
204337,1816,383,68,68,0
182047,1289,379,68,68,0
218341,1773,380,68,69,1
262629,1762,387,68,72,4
230372,1816,381,68,68,0
220388,1455,318,68,70,2
197604,1700,359,68,68,0
237283,1710,368,68,69,1
224483,1794,387,68,68,0
215267,1501,319,68,68,0
208099,1408,304,68,68,0
193250,1838,396,68,68,0
245986,1826,397,68,71,3
236258,1611,350,68,70,2
166114,1788,366,68,68,0
230882,1568,341,68,76,8
201186,1115,351,68,68,0
239841,1629,354,68,68,0
188128,1734,361,68,68,0
241632,1709,371,68,79,11
237024,1741,373,68,75,7
230624,1561,329,68,68,0
202464,1787,384,68,68,0
258015,1594,344,68,77,9
209637,1605,356,68,68,0
228069,1653,360,68,69,1
207409,1214,378,68,68,0
175589,1711,343,68,68,0
221489,1617,343,68,74,6
222513,1699,369,68,71,3
234033,1762,377,68,69,1
244017,1058,377,68,68,0
251185,1097,391,68,68,0
201266,1823,382,68,68,0
239922,1725,374,68,73,5
242482,1586,337,68,72,4
251954,1616,352,68,80,12
254258,1803,385,68,77,9
203315,1842,397,68,68,0
238643,1639,372,68,68,0
233780,1444,316,68,77,9
207669,1748,378,68,68,0
219957,1760,383,68,69,1
222773,1670,364,68,71,3
224821,1519,322,68,68,0
225589,1748,374,68,75,7
251445,1712,362,68,76,8
255461,1510,337,68,77,9
245733,1572,355,68,70,2
180255,1786,373,68,68,0
186655,1103,389,68,68,0
219998,1870,376,68,73,5
199769,1860,403,68,68,0
157528,1837,377,68,68,0
262744,1619,357,68,72,4
255319,1742,367,68,71,3
254551,1815,386,68,77,9
254039,1855,392,68,75,7
215383,1699,362,68,69,1
214615,1644,346,68,68,0
210263,1808,384,68,68,0
248106,1750,381,68,73,5
242006,1810,394,68,75,7
255573,1565,342,68,77,9
248149,1724,374,68,78,10
241237,1813,389,68,76,8
201301,1511,315,68,68,0
191572,1883,403,68,68,0
241236,1620,366,68,78,10
230228,1531,308,68,68,0
227412,1772,390,68,68,0
210004,1811,389,68,68,0
255827,1487,325,68,75,7
234579,1654,366,68,72,4
189272,1863,394,68,68,0
205145,1809,386,68,71,3
212819,1863,396,68,68,0
242265,1686,361,68,79,11
255069,1797,385,68,83,15
222557,1513,336,68,76,8
214877,1838,402,68,74,6
210269,1875,400,68,68,0
252508,1816,392,68,85,17
245340,1730,379,68,82,14
229212,1864,396,68,68,0
227932,1655,351,68,69,1
224604,1627,350,68,68,0
214876,1664,357,68,68,0
247643,1773,387,68,73,5
235355,1843,398,68,74,6
234587,1783,390,68,69,1
259674,1757,375,68,79,11
229210,1767,374,68,69,1
208730,1872,393,68,68,0
260185,1822,372,68,68,0
259929,1638,356,68,69,1
183385,1870,397,68,68,0
247385,1642,360,68,78,10
243801,1842,395,68,78,10
214611,1710,361,68,68,0
209746,1830,392,68,68,0
198688,1713,363,68,68,0
229925,1843,402,68,73,5
219941,1276,368,68,70,2
200741,1626,360,68,71,3
263205,1692,375,68,77,9
256292,1752,391,68,77,9
188196,1852,384,68,68,0
212516,1672,364,68,72,4
245283,1550,336,68,74,6
243235,1686,368,68,73,5
238882,1699,368,68,69,1
234018,1820,385,68,68,0
227362,1627,341,68,71,3
257057,1756,392,68,83,15
255009,1877,398,68,82,14
175393,1708,347,68,68,0
228897,1697,379,68,68,0
219937,1048,369,68,73,5
252448,1667,373,68,82,14
163616,1197,376,68,68,0
224544,1644,359,68,68,0
215328,1771,383,68,69,1
202528,1760,378,68,68,0
220965,1704,361,68,69,1
246565,1633,351,68,77,9
253265,1791,375,68,69,1
254245,1609,361,68,73,5
186449,1752,363,68,68,0
250961,1556,336,68,80,12
184913,1789,361,68,68,0
183377,1535,337,68,68,0
241489,1792,385,68,75,7
241233,1691,361,68,74,6
225105,1757,376,68,74,6
213841,1761,384,68,71,3
219177,1890,399,68,69,1
215081,1738,361,68,68,0
208681,1738,370,68,68,0
199721,1070,388,68,68,0
251944,972,348,68,74,6
223016,1622,345,68,68,0
197928,1206,379,68,70,2
257063,1677,363,68,83,15
253735,1627,352,68,78,10
260646,1591,349,68,68,0
250918,1838,402,68,69,1
248870,1833,395,68,80,12
208422,1940,404,68,68,0
200235,1528,321,68,68,0
215178,1520,333,68,69,1
246826,1524,330,68,73,5
245097,1719,372,68,79,11
50542,1681,326,68,68,0
210798,1689,367,68,68,0
223085,1882,396,68,68,0
217709,1427,299,68,68,0
202605,1678,361,68,69,1
193900,1800,387,68,68,0
239980,1894,398,68,70,2
213612,1766,389,68,69,1
223595,1752,380,68,69,1
237930,1483,335,68,76,8
243049,1843,389,68,81,13
230247,1728,367,68,68,0
172649,1751,348,68,68,0
227945,1628,349,68,72,4
207465,1849,384,68,68,0
262505,1613,350,68,78,10
243816,1580,343,68,73,5
172904,1744,356,68,68,0
234856,1708,378,68,73,5
226152,1869,392,68,72,4
208488,1511,337,68,68,0
258407,1742,377,68,81,13
222319,1636,368,68,73,5
243311,975,365,68,76,8
263280,1756,374,68,76,8
202864,1900,410,68,68,0
233917,1678,377,68,77,9
213949,1704,368,68,69,1
207805,1765,350,68,68,0
247228,899,351,68,76,8
181436,1632,343,68,68,0
169404,979,353,68,68,0
222396,1661,359,68,72,4
207804,1720,378,68,69,1
190139,1794,382,68,68,0
238011,1721,371,68,76,8
230075,1754,393,68,71,3
204987,1862,398,68,68,0
202171,1708,362,68,68,0
231354,1692,370,68,71,3
188601,1839,379,68,69,1
236217,1616,367,68,73,5
229817,1139,382,68,68,0
204217,1778,369,68,68,0
178616,1953,404,68,68,0
222576,1687,361,68,73,5
208240,1881,395,68,68,0
169575,1668,353,68,68,0
228711,1749,391,68,73,5
236308,1570,340,68,75,7
240663,1606,344,68,71,3
259423,1653,362,68,82,14
223769,1721,370,68,68,0
242200,1075,358,68,76,8
237848,1841,396,68,75,7
234264,1769,384,68,73,5
228888,1545,337,68,77,9
212248,1704,365,68,70,2
211736,1766,379,68,68,0
263704,1833,399,68,71,3
253463,1745,371,68,77,9
228375,1753,366,68,73,5
194150,1147,390,68,68,0
155671,1781,365,68,68,0
246806,1068,368,68,68,0
223510,1652,353,68,68,0
251413,1552,342,68,74,6
242453,1594,352,68,81,13
234005,1857,386,68,68,0
224021,1638,360,68,74,6
222741,1707,370,68,68,0
220693,1759,376,68,71,3
205589,1863,399,68,68,0
228704,1715,375,68,69,1
235360,1598,349,68,77,9
247648,1544,353,68,73,5
190560,1497,313,68,68,0
254054,1848,395,68,68,0
246118,1744,377,68,71,3
177766,1726,365,68,68,0
224358,1730,364,68,68,0
199526,1119,376,68,68,0
169317,1852,381,68,68,0
205669,1864,390,68,68,0
251236,1788,389,68,77,9
214884,1555,334,68,68,0
179811,1900,394,68,68,0
233571,1821,375,68,73,5
224099,1743,373,68,71,3
215139,1656,357,68,68,0
203363,1513,327,68,70,2
212066,1901,402,68,68,0
243553,1808,391,68,68,0
237665,1639,356,68,70,2
237409,1753,374,68,68,0
229473,1915,402,68,68,0
229217,1679,363,68,74,6
217441,1188,381,68,68,0
247229,1581,352,68,77,9
224702,1262,386,68,68,0
243134,1692,365,68,83,15
246845,1777,384,68,68,0
254267,1619,351,68,81,13
191547,1694,350,68,68,0
211004,1810,390,68,68,0
227900,1816,390,68,71,3
235580,1713,375,68,70,2
206653,1836,402,68,69,1
210237,1805,378,68,68,0
216381,1879,405,68,68,0
156221,1888,377,68,68,0
232253,1760,376,68,68,0
186941,1060,367,68,68,0
246974,1727,380,68,77,9
258365,1684,369,68,76,8
202558,1806,380,68,68,0
205630,1843,394,68,68,0
224062,1739,371,68,77,9
245822,1014,375,68,83,15
191294,1722,362,68,68,0
205631,1758,377,68,68,0
231231,1685,368,68,71,3
239679,1842,396,68,70,2
183871,1806,373,68,68,0
219451,1518,330,68,70,2
215355,1782,374,68,68,0
257338,1741,368,68,71,3
253242,1604,359,68,68,0
214582,1193,392,68,71,3
212790,1671,365,68,68,0
181558,1727,360,68,68,0
184630,1245,389,68,68,0
253238,1502,330,68,74,6
201271,1810,386,68,68,0
215351,1797,397,68,68,0
238391,1746,384,68,74,6
253239,1673,363,68,74,6
188727,1439,302,68,68,0
202808,1939,409,68,68,0
219448,1684,369,68,68,0
246840,1783,383,68,69,1
202041,1734,382,68,68,0
215097,1124,380,68,71,3
224057,1849,388,68,68,0
244793,1553,335,68,70,2
253241,1596,356,68,73,5
194873,1845,390,68,68,0
242490,1741,383,68,73,5
246074,1771,382,68,76,8
192319,1855,389,68,68,0
232512,1754,374,68,68,0
234048,1855,400,68,73,5
193475,1832,382,68,68,0
235971,1805,382,68,70,2
232643,1654,368,68,72,4
204227,1613,348,68,69,1
253122,1769,390,68,77,9
186562,1778,384,68,68,0
183490,1684,360,68,68,0
241858,1585,358,68,76,8
235458,1477,336,68,72,4
211394,1748,382,68,68,0
256705,1638,363,68,71,3
244161,1699,371,68,71,3
241089,1717,381,68,71,3
231873,1754,376,68,77,9
198849,1791,365,68,68,0
189120,1793,377,68,68,0
252864,1677,360,68,74,6
231616,1620,357,68,74,6
210879,1612,347,68,68,0
208063,1842,388,68,68,0
254142,1834,397,68,75,7
251326,1814,390,68,77,9
255939,1476,326,68,83,15
201924,1630,339,68,68,0
241984,1518,339,68,68,0
212420,1470,326,68,70,2
201025,1799,380,68,68,0
203329,1663,349,68,68,0
204353,1776,377,68,68,0
205377,1196,380,68,70,2
219969,1042,371,68,73,5
234817,1554,339,68,76,8
238657,1870,395,68,68,0
241985,1811,380,68,70,2
243521,1728,379,68,77,9
234184,1671,362,68,74,6
212680,1711,368,68,69,1
237511,1698,371,68,76,8
222407,1655,343,68,71,3
231878,1066,367,68,71,3
231110,1446,320,68,71,3
241861,1824,394,68,76,8
248004,1602,350,68,76,8
243908,1467,317,68,77,9
243652,1582,332,68,79,11
237764,1859,387,68,68,0
214980,1631,350,68,68,0
247060,1710,368,68,76,8
234004,1657,362,68,68,0
236842,1756,373,68,80,12
219575,1646,354,68,68,0
183442,1897,398,68,68,0
253586,1504,328,68,74,6
191625,1724,356,68,68,0
189586,1176,363,68,68,0
256658,1661,367,68,79,11
191378,1796,378,68,68,0
192658,1799,381,68,68,0
192695,1695,368,68,68,0
256695,1703,381,68,68,0
233911,1733,364,68,71,3
209335,1839,395,68,69,1
234164,1694,359,68,68,0
203447,1770,376,68,68,0
255158,1548,338,68,79,11
189110,1647,347,68,68,0
237494,1561,342,68,68,0
227766,1456,319,68,72,4
244661,1744,380,68,77,9
233141,1723,360,68,68,0
229045,1675,374,68,69,1
222389,1194,384,68,73,5
214965,1680,353,68,68,0
232594,1726,375,68,68,0
230802,1756,374,68,68,0
243857,1690,365,68,69,1
239505,1811,384,68,69,1
238989,1861,397,68,68,0
247949,1622,368,68,74,6
253581,1797,376,68,68,0
233870,1637,350,68,68,0
235662,1679,373,68,77,9
237198,1638,353,68,71,3
255886,1740,378,68,75,7
258958,1608,340,68,68,0
201103,1898,403,68,68,0
236943,1737,386,68,72,4
193679,1645,349,68,68,0
198288,1797,380,68,68,0
225168,1730,365,68,68,0
231056,1194,376,68,69,1
244624,1715,368,68,75,7
262801,1621,349,68,68,0
264337,1721,366,68,80,12
211089,1593,341,68,69,1
234129,1697,353,68,76,8
234385,1772,370,68,72,4
238225,1728,373,68,73,5
193716,1562,344,68,68,0
223668,1611,366,68,69,1
215572,1769,379,68,69,1
177320,1733,360,68,68,0
207531,1539,326,68,68,0
251818,1162,398,68,68,0
237994,1725,363,68,74,6
236458,1579,339,68,72,4
222889,1397,302,68,68,0
205481,1813,391,68,71,3
200105,1678,357,68,68,0
258728,1630,356,68,78,10
255400,1496,326,68,76,8
178600,1529,328,68,68,0
240040,1713,366,68,76,8
211635,1910,408,68,68,0
216232,1800,385,68,68,0
244135,1416,306,68,70,2
228007,1825,383,68,69,1
161703,1863,374,68,68,0
194726,1788,379,68,68,0
234025,1752,353,68,68,0
194089,1851,376,68,68,0
201514,1817,389,68,68,0
209194,1349,289,68,68,0
227370,1128,381,68,73,5
234667,1722,377,68,68,0
237739,1663,367,68,71,3
253100,1775,383,68,80,12
190636,1802,367,68,68,0
255154,1642,361,68,77,9
252594,1577,341,68,82,14
247474,1609,364,68,72,4
219871,1837,397,68,68,0
241842,1656,360,68,78,10
225202,1823,391,68,73,5
211378,1900,399,68,68,0
256689,1687,359,68,76,8
252081,996,375,68,70,2
179633,1924,408,68,68,0
234929,1752,371,68,69,1
199601,1937,401,68,68,0
188336,1533,326,68,68,0
236464,1654,371,68,73,5
257711,1670,363,68,81,13
244399,1882,407,68,74,6
237743,1737,375,68,70,2
203439,1688,364,68,68,0
203183,1776,377,68,68,0
229038,1743,368,68,77,9
223150,1211,380,68,72,4
258444,1596,354,68,80,12
252044,1659,361,68,78,10
247180,1736,380,68,77,9
215309,1702,357,68,68,0
252943,1824,389,68,80,12
244751,1572,356,68,71,3
228111,1845,399,68,71,3
209935,1544,335,68,68,0
236046,1018,357,68,76,8
259853,1826,385,68,79,11
184845,1665,356,68,68,0
246797,1811,379,68,71,3
230157,1850,405,68,68,0
221197,1735,388,68,72,4
236300,1753,375,68,68,0
214412,1755,376,68,68,0
222988,1838,372,68,68,0
221452,1759,372,68,70,2
198156,1739,382,68,68,0
183819,1798,377,68,68,0
236555,1690,350,68,73,5
211723,1484,320,68,69,1
241930,1596,347,68,78,10
227594,1651,363,68,69,1
210698,1789,378,68,69,1
205578,1667,370,68,69,1
253455,1556,338,68,71,3
258575,1531,347,68,75,7
197904,1536,340,68,69,1
215568,1711,365,68,68,0
207892,1851,404,68,68,0
262932,1665,357,68,68,0
228883,1656,366,68,74,6
226579,1721,375,68,77,9
225811,1630,358,68,71,3
214035,1120,379,68,70,2
203795,1433,308,68,68,0
203283,1657,356,68,68,0
240658,1827,392,68,74,6
239378,1676,355,68,76,8
229650,1756,377,68,72,4
204050,1554,332,68,68,0
254225,1620,343,68,77,9
54033,1791,364,68,68,0
243473,1757,386,68,73,5
239121,1570,340,68,68,0
235537,1851,394,68,79,11
221713,1835,381,68,68,0
220433,1179,382,68,71,3
231184,1633,349,68,73,5
221456,1571,352,68,73,5
224009,1703,376,68,71,3
221705,1857,393,68,71,3
215817,1674,349,68,69,1
229379,1747,367,68,75,7
212483,1788,383,68,68,0
199683,1842,394,68,68,0
198147,1663,350,68,68,0
188930,1772,376,68,68,0
252162,1655,365,68,75,7
212994,1658,357,68,71,3
264450,1726,372,68,78,10
256001,1676,370,68,69,1
243201,1115,377,68,78,10
244480,1759,375,68,74,6
218880,1544,326,68,72,4
212992,1735,372,68,68,0
223370,1718,369,68,68,0
232586,1736,379,68,71,3
238986,1371,295,68,71,3
259978,1738,370,68,78,10
224395,1838,381,68,68,0
236427,1677,374,68,75,7
244363,975,357,68,74,6
246923,1722,377,68,82,14
261771,1657,358,68,82,14
215043,1810,381,68,68,0
229891,1814,389,68,73,5
209417,1941,409,68,68,0
246275,1487,337,68,74,6
256008,1552,352,68,84,16
229640,1788,389,68,73,5
158984,1734,370,68,68,0
223752,1653,356,68,74,6
221704,1117,380,68,73,5
214280,1745,380,68,71,3
190471,1806,362,68,68,0
223751,1662,369,68,69,1
218887,1814,383,68,73,5
212487,1639,354,68,73,5
189958,1763,363,68,68,0
229894,1823,393,68,71,3
261381,1829,382,68,68,0
190981,1699,365,68,68,0
168965,1183,383,68,68,0
213509,1460,311,68,68,0
203781,1794,380,68,68,0
264453,1668,371,68,84,16
246276,1568,350,68,77,9
232708,1805,380,68,75,7
254211,1703,366,68,75,7
240351,1790,392,68,72,4
204354,1258,384,68,69,1
213471,1799,369,68,71,3
253136,1791,376,68,77,9
255441,1609,361,68,79,11
179665,1790,365,68,68,0
235729,1410,310,68,73,5
166097,1211,394,68,68,0
214993,1579,332,68,68,0
201681,1835,408,68,68,0
212944,1822,386,68,71,3
215250,1129,374,68,68,0
208592,1790,379,68,68,0
205008,1703,365,68,68,0
190671,1885,393,68,68,0
242383,1622,351,68,73,5
235215,1709,357,68,75,7
229839,1660,365,68,70,2
206546,1649,336,68,70,2
227794,1870,388,68,73,5
211671,1778,376,68,70,2
237780,1830,387,68,68,0
215254,1429,291,68,68,0
230357,1820,377,68,68,0
219605,1836,396,68,70,2
259796,1598,352,68,69,1
253908,1767,371,68,77,9
244692,1855,397,68,78,10
219860,1553,335,68,68,0
236242,1607,340,68,71,3
191443,1585,332,68,68,0
246739,1810,374,68,70,2
222163,1700,359,68,68,0
219091,1814,390,68,73,5
186578,1845,384,68,68,0
237010,1755,381,68,70,2
228303,1755,384,68,68,0
216271,1602,349,68,71,3
239822,1653,361,68,71,3
236535,1850,407,68,74,6
192201,1153,383,68,68,0
235464,1483,331,68,75,7
190942,1744,365,68,68,0
211703,1787,371,68,68,0
167159,1442,301,68,68,0
232695,1451,314,68,68,0
200440,1792,382,68,68,0
231886,1841,403,68,71,3
204280,1838,395,68,68,0
214776,1865,402,68,68,0
263929,1708,366,68,81,13
223737,1160,379,68,70,2
225529,1711,366,68,71,3
235513,1607,357,68,73,5
212938,1620,358,68,69,1
236490,1678,357,68,75,7
200395,1531,313,68,68,0
201163,1717,366,68,68,0
212939,1707,362,68,68,0
216523,1345,307,68,69,1
221643,1871,386,68,68,0
226507,1713,365,68,72,4
212940,1681,368,68,71,3
216268,1755,376,68,68,0
222156,1677,366,68,75,7
227788,1832,399,68,69,1
233164,1158,393,68,78,10
210381,1851,397,68,68,0
240589,1652,360,68,79,11
242381,1781,376,68,76,8
248781,1465,323,68,69,1
220886,1682,363,68,73,5
235735,1569,342,68,82,14
199674,1589,324,68,68,0
240027,1662,359,68,68,0
198810,1605,346,68,69,1
217242,1940,405,68,68,0
254874,1778,387,68,68,0
213147,1866,398,68,71,3
215195,1791,375,68,72,4
226203,1863,405,68,68,0
261275,1627,357,68,76,8
178584,1396,289,68,68,0
238236,1801,390,68,77,9
229277,1662,366,68,72,4
233373,1731,368,68,73,5
237213,1713,367,68,75,7
237469,1773,393,68,74,6
242845,1770,373,68,73,5
248729,1645,363,68,81,13
223128,1806,375,68,69,1
235991,1765,369,68,79,11
257270,1738,386,68,81,13
264181,1850,387,68,81,13
211189,1456,320,68,68,0
234229,1826,407,68,77,9
242677,1661,358,68,77,9
245237,1749,385,68,77,9
186101,1411,320,68,68,0
235670,1878,398,68,73,5
221336,1830,377,68,73,5
239254,1048,361,68,80,12
243862,1947,411,68,71,3
194198,1057,383,68,68,0
246679,1737,380,68,78,10
253847,1193,385,68,70,2
212120,1544,325,68,69,1
247197,1650,362,68,70,2
211870,1772,369,68,68,0
222878,1740,372,68,74,6
242596,1717,383,68,73,5
201891,1794,365,68,68,0
215459,1777,371,68,68,0
227235,1895,406,68,68,0
239267,1652,370,68,80,12
243619,1646,375,68,73,5
246179,1797,377,68,77,9
259748,1530,338,68,80,12
233630,1663,356,68,73,5
203173,1824,389,68,68,0
225189,1806,377,68,72,4
246437,1816,386,68,68,0
219558,1771,384,68,68,0
221350,1708,370,68,74,6
240343,1939,411,68,71,3
246946,1874,406,68,79,11
244641,1570,335,68,69,1
231073,1115,382,68,70,2
215969,1730,359,68,68,0
202401,1640,350,68,68,0
258464,1395,312,68,75,7
253344,1611,354,68,75,7
183712,1612,336,68,68,0
241824,1436,327,68,74,6
240032,1788,391,68,68,0
232608,1630,366,68,68,0
213152,1648,359,68,71,3
199584,1909,399,68,68,0
198560,1772,376,68,68,0
263072,1741,371,68,71,3
230047,1718,367,68,72,4
216479,1640,359,68,68,0
259833,1675,365,68,78,10
200954,1749,360,68,68,0
190196,1574,346,68,68,0
226431,1908,402,68,75,7
229501,1116,384,68,70,2
232573,1750,387,68,68,0
234877,939,365,68,73,5
208766,1693,361,68,68,0
226686,1782,378,68,73,5
210303,1769,376,68,68,0
235647,1654,361,68,73,5
253052,1654,370,68,82,14
236671,1831,392,68,75,7
242815,1756,357,68,77,9
194431,1825,391,68,68,0
169600,1725,350,68,68,0
238464,1591,345,68,76,8
228225,1674,373,68,71,3
232870,1467,317,68,71,3
221820,1847,382,68,68,0
234472,1560,342,68,77,9
242406,1592,343,68,75,7
235495,1705,369,68,69,1
234983,1954,414,68,74,6
226535,1685,371,68,68,0
223207,1583,331,68,69,1
215527,1586,341,68,68,0
202215,1167,382,68,68,0
239590,1470,309,68,68,0
220028,1732,387,68,71,3
222587,1719,376,68,71,3
232571,1489,328,68,73,5
233851,1821,394,68,73,5
237435,1651,348,68,76,8
254587,1907,408,68,79,11
210044,1452,321,68,68,0
230273,1684,354,68,68,0
253569,1649,363,68,73,5
255105,1662,366,68,74,6
206472,1818,389,68,68,0
147846,1761,354,68,68,0
239494,1695,371,68,75,7
248710,1679,355,68,74,6
256902,1858,392,68,71,3
214151,1883,378,68,68,0
198024,1812,389,68,68,0
207496,1633,339,68,68,0
215938,1875,401,68,68,0
239496,1660,355,68,74,6
254088,1627,343,68,85,17
200841,1803,377,68,68,0
207753,1362,290,68,68,0
208521,1464,296,68,68,0
182409,1947,402,68,68,0
255109,1859,395,68,75,7
240773,1699,368,68,76,8
239493,1681,369,68,76,8
236165,1695,355,68,68,0
183940,1775,372,68,68,0
237700,1724,376,68,74,6
167812,1622,348,68,68,0
155524,1443,300,68,68,0
199812,1135,376,68,68,0
252291,1713,364,68,75,7
251779,1590,341,68,72,4
234371,923,377,68,72,4
220291,1787,379,68,70,2
214915,1800,388,68,68,0
242306,1563,342,68,69,1
172418,1734,355,68,68,0
232066,1619,345,68,71,3
200168,1598,348,68,68,0
254952,1512,334,68,78,10
225530,1570,348,68,71,3
211955,1656,361,68,68,0
245247,1809,397,68,76,8
250868,1911,403,68,69,1
175092,1800,363,68,68,0
183795,1382,292,68,68,0
247027,1661,377,68,71,3
240371,1007,374,68,72,4
247026,1772,385,68,79,11
235519,1728,364,68,75,7
244210,1750,372,68,75,7
228082,1795,389,68,76,8
198642,1513,313,68,68,0
260593,1795,385,68,74,6
257265,1668,371,68,74,6
188657,1189,380,68,68,0
236543,1063,362,68,73,5
234239,1765,374,68,71,3
257000,1533,332,68,81,13
202749,1759,366,68,68,0
238330,1563,351,68,70,2
244474,1828,398,68,68,0
237307,1803,390,68,72,4
200700,1871,388,68,68,0
202748,1751,373,68,68,0
251644,1541,334,68,68,0
239357,1720,384,68,68,0
230143,1529,318,68,68,0
253181,1745,385,68,77,9
217086,1901,411,68,68,0
240638,1870,402,68,75,7
242174,1725,370,68,73,5
212223,1742,380,68,69,1
229375,1723,377,68,74,6
178417,1807,364,68,68,0
233457,1761,392,68,69,1
228593,1767,381,68,73,5
220139,1858,392,68,70,2
169708,1735,360,68,68,0
220140,1538,341,68,72,4
260843,1725,368,68,79,11
259307,1782,389,68,81,13
248811,1749,373,68,77,9
248043,1800,375,68,68,0
251626,1656,368,68,77,9
226033,1803,379,68,68,0
244970,1723,375,68,75,7
236522,1600,346,68,76,8
214250,1772,399,68,68,0
193001,1728,362,68,68,0
238569,1785,392,68,68,0
206313,1857,398,68,68,0
237548,1696,373,68,68,0
199917,1906,400,68,69,1
201965,1889,406,68,68,0
184301,1810,380,68,68,0
201966,1719,361,68,68,0
136686,1211,390,68,68,0
230638,1701,373,68,69,1
169710,1776,369,68,68,0
202223,1888,398,68,68,0
223727,1223,388,68,70,2
245231,1690,366,68,75,7
214000,1806,387,68,68,0
237040,1502,320,68,74,6
244464,1715,377,68,69,1
254448,1720,362,68,73,5
260592,1745,380,68,86,18
206065,1202,391,68,71,3
198133,2008,422,68,68,0
208631,1742,337,68,68,0
238965,1711,366,68,73,5
225139,1765,370,68,68,0
222066,1786,365,68,69,1
232562,1085,376,68,72,4
239986,1774,371,68,78,10
260823,1810,381,68,83,15
182743,1052,365,68,68,0
223344,1804,387,68,71,3
251504,1658,358,68,75,7
213105,1823,380,68,69,1
223857,1726,387,68,68,0
231025,1755,364,68,74,6
243057,1671,361,68,82,14
259953,1672,369,68,68,0
200818,1510,322,68,68,0
213106,1927,401,68,68,0
241010,1500,334,68,69,1
254578,1719,367,68,84,16
256370,1751,383,68,68,0
263283,950,376,68,70,2
213619,1585,340,68,68,0
213878,1731,356,68,68,0
216182,1719,350,68,68,0
243574,1740,389,68,74,6
245368,1588,342,68,75,7
201083,1814,381,68,68,0
200059,1202,384,68,69,1
239738,1703,364,68,77,9
228730,1542,329,68,75,7
225145,1638,352,68,68,0
157305,1810,359,68,68,0
204153,1880,391,68,68,0
253816,1808,382,68,76,8
244344,1798,391,68,72,4
186998,1231,392,68,68,0
216184,1887,392,68,68,0
219767,1588,351,68,69,1
214135,1463,321,68,68,0
201847,1014,372,68,70,2
189558,1593,331,68,68,0
188278,1126,386,68,68,0
253302,1776,365,68,68,0
244085,1624,358,68,69,1
223603,1040,370,68,71,3
230515,1733,353,68,68,0
252376,1802,386,68,78,10
258264,932,371,68,71,3
221658,1612,357,68,69,1
233178,1809,376,68,74,6
234202,1613,360,68,73,5
227547,1778,378,68,69,1
228827,1910,411,68,72,4
230363,1864,386,68,68,0
244187,1661,367,68,71,3
179931,1692,364,68,68,0
190939,1788,368,68,68,0
209372,1804,376,68,68,0
210140,1228,375,68,68,0
216284,1438,329,68,70,2
234972,1707,376,68,68,0
263389,1787,381,68,68,0
169181,1322,391,68,68,0
173533,1148,388,68,68,0
177373,1637,352,68,68,0
216286,1930,406,68,68,0
176094,1161,385,68,68,0
216281,1762,376,68,68,0
219771,1749,362,68,68,0
241523,1663,358,68,78,10
238040,1497,327,68,75,7
252275,1620,358,68,73,5
254067,1677,366,68,71,3
194163,1823,375,68,68,0
200820,1933,400,68,68,0
211060,1883,404,68,68,0
221556,1793,382,68,69,1
225396,1504,314,68,70,2
225652,1698,356,68,73,5
229748,1682,375,68,69,1
235124,1078,392,68,76,8
235636,1768,376,68,74,6
239476,1701,374,68,73,5
247668,1849,405,68,79,11
254068,1706,365,68,74,6
198517,1853,387,68,68,0
199384,1731,368,68,68,0
202968,1762,378,68,68,0
148696,1937,392,68,68,0
230872,1277,389,68,80,12
236963,1079,365,67,72,5
201038,1718,363,67,67,0
231587,1772,378,67,73,6
177564,1818,378,67,67,0
186781,1079,360,67,67,0
250781,962,351,67,67,0
230557,1727,371,67,73,6
222109,1813,393,67,70,3
204445,1756,371,67,67,0
262301,1745,372,67,68,1
261532,1703,365,67,75,8
253596,1697,350,67,67,0
250780,1485,324,67,74,7
243100,1722,374,67,70,3
242332,1883,386,67,81,14
164766,1748,375,67,67,0
232860,1870,398,67,67,0
222876,1097,354,67,69,2
251547,1736,388,67,75,8
246683,1738,374,67,80,13
210843,1747,374,67,67,0
216218,1727,363,67,69,2
263578,1482,341,67,83,16
235022,1759,368,67,73,6
207887,1865,396,67,68,1
213007,1701,359,67,67,0
217502,1111,375,67,67,0
235166,1728,376,67,73,6
225187,1813,382,67,69,2
236192,1726,361,67,67,0
135587,1071,366,67,67,0
241570,1757,374,67,76,9
239010,1660,360,67,69,2
226210,1705,366,67,72,5
256161,998,360,67,79,12
254881,1852,384,67,67,0
252577,1646,360,67,78,11
235425,1775,384,67,74,7
222369,1740,378,67,72,5
247200,1548,328,67,70,3
229536,1679,367,67,70,3
251806,1803,395,67,79,12
225440,1738,373,67,70,3
159904,1154,374,67,67,0
251551,1632,358,67,76,9
236191,1681,362,67,67,0
230815,1492,335,67,72,5
221599,1600,363,67,67,0
214175,1641,356,67,67,0
263583,1846,388,67,67,0
258718,1030,362,67,74,7
252318,1494,327,67,73,6
230559,1682,355,67,72,5
237989,1857,393,67,67,0
253347,1682,377,67,71,4
264201,1845,386,67,76,9
234249,1556,336,67,75,8
255753,1521,348,67,71,4
260105,1543,335,67,82,15
263946,1683,362,67,78,11
199946,1758,370,67,67,0
210954,1612,342,67,67,0
215818,1803,373,67,71,4
238346,1732,377,67,72,5
244234,1675,367,67,75,8
246282,1668,357,67,73,6
251914,1560,336,67,74,7
215563,1748,370,67,67,0
189451,1647,342,67,67,0
262412,1667,358,67,76,9
201484,1803,384,67,67,0
206089,1831,390,67,70,3
255240,1459,318,67,73,6
205068,1100,356,67,67,0
254472,1707,358,67,79,12
215557,1685,369,67,70,3
242181,1727,385,67,72,5
254725,1575,342,67,78,11
259845,1121,357,67,67,0
232454,1386,286,67,67,0
244486,1584,353,67,71,4
208391,1607,363,67,67,0
210439,1661,351,67,67,0
222215,1906,409,67,68,1
229127,1101,373,67,74,7
240903,1675,366,67,70,3
242183,1603,348,67,75,8
213512,1897,393,67,67,0
217096,1140,379,67,72,5
241672,1361,303,67,67,0
204044,1780,369,67,67,0
240908,1525,330,67,75,8
142756,1786,361,67,67,0
182207,1145,365,67,67,0
264383,1667,360,67,75,8
243646,1590,341,67,76,9
238526,1014,382,67,76,9
238270,1726,374,67,72,5
238014,1621,339,67,67,0
237758,1694,386,67,72,5
246438,1683,357,67,67,0
244134,1762,390,67,79,12
235942,1617,343,67,73,6
228774,1865,394,67,73,6
253349,1652,360,67,72,5
184229,1763,381,67,67,0
222991,1671,353,67,67,0
200357,1451,317,67,67,0
235684,1579,334,67,69,2
222399,1723,371,67,70,3
184255,1662,347,67,67,0
251916,1674,368,67,78,11
193057,1714,362,67,67,0
192012,1456,307,67,68,1
257804,1483,318,67,77,10
212493,1731,365,67,68,1
230413,1675,356,67,67,0
239629,1740,386,67,74,7
240653,1819,384,67,70,3
251149,1504,323,67,67,0
251405,1512,332,67,78,11
262414,1718,366,67,76,9
224014,1765,369,67,67,0
252706,1761,389,67,76,9
244514,1602,347,67,67,0
244258,1052,371,67,67,0
239394,1662,363,67,70,3
228130,1074,379,67,67,0
23823,1704,340,67,67,0
243478,1740,364,67,80,13
256271,1672,360,67,67,0
260265,1814,375,67,68,1
234668,1643,362,67,73,6
184747,1688,341,67,67,0
233643,1575,348,67,69,2
229803,1698,357,67,70,3
244394,1558,340,67,78,11
235946,1682,359,67,76,9
254889,1779,365,67,67,0
182440,1760,363,67,67,0
178089,1805,388,67,67,0
241833,1859,395,67,72,5
234665,1458,316,67,69,2
232873,1502,348,67,72,5
214697,1748,372,67,67,0
210601,1742,383,67,67,0
257196,1675,363,67,70,3
213933,1768,385,67,73,6
234925,1751,374,67,77,10
235949,1563,334,67,72,5
175789,1884,401,67,67,0
251309,1766,378,67,73,6
214446,1738,373,67,68,1
232622,1483,319,67,67,0
234158,1606,355,67,72,5
237742,1759,389,67,69,2
243886,1707,375,67,71,4
244654,958,361,67,74,7
242863,1723,375,67,74,7
244143,1697,370,67,75,8
255151,927,364,67,77,10
260271,1605,347,67,71,4
211888,1707,375,67,67,0
201129,1778,382,67,67,0
232360,1734,373,67,70,3
243632,1616,358,67,75,8
252193,1677,360,67,79,12
203265,1761,375,67,67,0
199169,1758,376,67,67,0
243968,1727,367,67,68,1
240640,1604,347,67,67,0
236288,1896,406,67,71,4
253473,1771,372,67,84,17
245537,1570,352,67,79,12
216744,1512,326,67,70,3
242209,1712,378,67,67,0
259360,926,358,67,81,14
252704,1629,351,67,77,10
251936,1722,360,67,68,1
237600,1799,383,67,72,5
229664,1700,370,67,67,0
204033,1775,391,67,67,0
253953,1765,388,67,75,8
215810,1595,351,67,67,0
216834,1834,388,67,67,0
223746,1690,360,67,67,0
228354,1816,391,67,71,4
229890,1676,371,67,70,3
242946,1762,381,67,73,6
188674,1868,381,67,67,0
182694,1734,370,67,67,0
257190,1545,343,67,75,8
262311,1614,359,67,77,10
202663,1755,369,67,67,0
221095,1744,367,67,70,3
230055,1717,373,67,74,7
232871,1789,374,67,70,3
180903,1818,379,67,67,0
225712,1756,383,67,67,0
200113,1653,359,67,67,0
194319,1770,368,67,67,0
242964,1629,356,67,81,14
246803,1849,403,67,71,4
247315,1788,386,67,67,0
258893,1423,311,67,77,10
261139,1725,375,67,70,3
204820,1712,368,67,67,0
227604,1611,348,67,72,5
192020,1767,380,67,67,0
215574,1886,394,67,72,5
208917,1699,367,67,67,0
230933,1586,337,67,71,4
232469,1696,358,67,67,0
243733,1806,392,67,71,4
255253,1775,368,67,81,14
202518,1894,398,67,67,0
176403,1753,366,67,67,0
239635,1705,378,67,72,5
232467,1884,393,67,67,0
211987,1770,373,67,70,3
242194,1631,339,67,67,0
234258,1789,379,67,73,6
231442,1664,367,67,75,8
215314,1470,314,67,67,0
210706,1806,387,67,67,0
200466,1095,375,67,67,0
244753,1657,356,67,72,5
240913,1042,370,67,79,12
248080,1808,385,67,70,3
179984,1499,324,67,67,0
202512,1821,387,67,67,0
262416,1650,362,67,80,13
261647,1455,335,67,81,14
205846,1719,367,67,67,0
229910,1729,384,67,74,7
225713,1635,349,67,70,3
224690,1870,382,67,67,0
209667,1529,332,67,68,1
214195,1727,374,67,68,1
204211,1653,348,67,67,0
191154,1749,368,67,67,0
246450,1634,363,67,76,9
237490,1773,371,67,74,7
214706,1260,378,67,67,0
230166,1177,374,67,67,0
202162,1650,345,67,67,0
191153,1135,363,67,68,1
251057,1011,354,67,71,4
181681,1864,380,67,67,0
231601,1682,351,67,68,1
230321,1108,366,67,67,0
156675,1541,320,67,67,0
243481,1719,382,67,81,14
241689,1707,384,67,78,11
233241,1751,376,67,73,6
220185,1627,361,67,72,5
210713,1853,401,67,68,1
207641,1815,385,67,67,0
246808,1661,366,67,70,3
245528,1587,338,67,70,3
245016,1807,395,67,73,6
170008,1169,375,67,67,0
229912,1711,379,67,73,6
259607,1368,295,67,67,0
234007,1726,361,67,67,0
255766,1580,339,67,69,2
261636,1586,345,67,74,7
243222,1815,391,67,78,11
263941,1593,346,67,76,9
241445,1593,350,67,72,5
257540,1615,356,67,80,13
256516,1632,350,67,81,14
256107,1683,368,67,73,6
247147,1550,342,67,72,5
233835,1712,375,67,76,9
232811,1829,390,67,67,0
228971,1694,352,67,67,0
212075,1731,379,67,67,0
258922,1513,336,67,79,12
255082,1806,382,67,68,1
251754,1538,337,67,73,6
251498,946,356,67,73,6
245098,1530,327,67,67,0
238186,992,355,67,76,9
236650,1796,386,67,74,7
220801,1747,379,67,67,0
216193,1469,311,67,67,0
205185,1558,349,67,68,1
253824,1816,394,67,71,4
192363,1644,344,67,67,0
157804,1122,367,67,67,0
226924,1902,397,67,67,0
238446,1398,302,67,76,9
239215,1758,380,67,76,9
227951,1564,343,67,76,9
219759,1713,367,67,67,0
199535,1711,376,67,67,0
192110,1716,366,67,67,0
248174,1724,368,67,77,10
179822,1808,385,67,67,0
234350,1703,375,67,73,6
166764,1214,379,67,67,0
213614,1775,377,67,70,3
173165,1033,354,67,67,0
227693,1645,349,67,73,6
222573,1923,416,67,72,5
199277,1786,360,67,67,0
192620,1600,324,67,67,0
242284,1687,358,67,72,5
251776,1638,355,67,68,1
179840,1413,306,67,67,0
213375,1733,376,67,67,0
202106,1901,375,67,67,0
256890,1780,383,67,81,14
190330,1807,375,67,67,0
243834,1687,367,67,76,9
225146,1872,411,67,71,4
223354,1938,405,67,67,0
214650,1748,382,67,70,3
204922,1015,354,67,69,2
254585,1783,381,67,77,10
199803,1090,361,67,67,0
252793,1606,349,67,81,14
212601,1682,373,67,68,1
201081,1577,344,67,68,1
239224,1729,370,67,73,6
222840,1739,376,67,70,3
198776,1692,355,67,67,0
259959,1655,363,67,74,7
259706,1556,343,67,67,0
216187,1519,320,67,67,0
260478,1697,379,67,77,10
169596,1448,304,67,67,0
237438,1621,350,67,69,2
234622,1779,383,67,68,1
220030,1741,373,67,68,1
254333,1674,352,67,78,11
238461,1681,366,67,76,9
168317,1678,351,67,67,0
251260,1691,366,67,72,5
208764,1072,363,67,68,1
219259,1900,403,67,71,4
205948,1808,383,67,67,0
202620,1874,404,67,67,0
261499,1006,370,67,77,10
193147,1816,374,67,67,0
252027,1832,395,67,85,18
244603,1658,355,67,83,16
234107,1736,380,67,76,9
240751,949,352,67,75,8
261999,1612,338,67,70,3
214896,1757,373,67,68,1
237254,1533,337,67,76,9
198856,1597,350,67,67,0
260807,1779,373,67,67,0
189383,1839,375,67,67,0
223687,1622,359,67,67,0
213959,1803,379,67,72,5
207559,1792,383,67,68,1
239558,1749,376,67,75,8
233158,1812,377,67,67,0
233928,1700,357,67,76,9
253637,1178,375,67,68,1
241093,1748,379,67,74,7
238277,1766,383,67,72,5
237509,1559,359,67,78,11
224965,1686,348,67,67,0
212165,1800,387,67,67,0
234948,1781,384,67,72,5
221896,1698,350,67,70,3
225993,1161,367,67,71,4
222916,1756,382,67,72,5
193226,1647,341,67,67,0
234892,1696,369,67,72,5
236940,1517,318,67,73,6
260811,1539,328,67,67,0
256971,1714,381,67,79,12
190667,1710,353,67,67,0
187339,1819,379,67,67,0
227787,1837,378,67,67,0
253130,1712,362,67,83,16
248009,1902,395,67,67,0
246730,1639,354,67,67,0
239050,1427,298,67,69,2
225738,1660,329,67,74,7
217802,1765,370,67,67,0
212170,1781,386,67,70,3
206538,1726,379,67,67,0
251337,1585,340,67,69,2
232388,1795,381,67,68,1
264388,1680,358,67,81,14
233840,1693,368,67,73,6
182897,1152,375,67,67,0
242802,944,356,67,75,8
241266,1616,353,67,77,10
240498,1874,409,67,72,5
169586,1750,364,67,67,0
231538,1691,363,67,70,3
263282,1799,388,67,70,3
191089,1642,334,67,67,0
236657,1893,406,67,77,10
253810,1809,386,67,68,1
222577,1765,374,67,68,1
210801,1803,386,67,67,0
135537,1753,358,67,67,0
254320,1683,363,67,80,13
253296,1647,354,67,75,8
238704,1640,362,67,74,7
236144,1703,373,67,67,0
253554,1674,371,67,67,0
211315,1508,322,67,69,2
234179,1673,361,67,67,0
252865,1572,346,67,79,12
220355,1613,340,67,67,0
214211,1709,373,67,67,0
260290,1565,340,67,75,8
251330,935,364,67,78,11
235714,1727,356,67,75,8
214722,1612,360,67,67,0
206530,1593,347,67,71,4
182209,1507,323,67,67,0
211827,1102,366,67,71,4
231105,1122,378,67,72,5
228033,1848,390,67,67,0
182464,1799,384,67,67,0
223680,1770,379,67,73,6
242547,1697,370,67,70,3
228211,1705,357,67,70,3
220019,1620,354,67,70,3
190583,1578,345,67,67,0
254071,1709,372,67,67,0
224375,1853,397,67,67,0
225174,1887,386,67,70,3
224915,1610,353,67,72,5
228243,1574,356,67,72,5
229267,1784,395,67,70,3
215700,1913,403,67,70,3
235157,1533,334,67,73,6
256149,1646,357,67,78,11
212374,1786,390,67,68,1
227990,1812,379,67,67,0
256402,1774,380,67,82,15
229270,1733,377,67,69,2
243606,1707,361,67,77,10
248470,1383,314,67,75,8
203159,1326,290,67,67,0
205975,1692,365,67,67,0
228759,1738,371,67,72,5
232599,1763,382,67,73,6
201875,1218,374,67,67,0
251026,1894,395,67,67,0
244375,1676,352,67,69,2
230288,1725,376,67,67,0
226702,1803,375,67,73,6
238222,1637,365,67,74,7
212367,1724,374,67,68,1
238479,1620,346,67,68,1
246159,1771,394,67,82,15
246927,1680,359,67,72,5
223120,1617,343,67,72,5
240784,1321,370,67,79,12
241810,1535,326,67,78,11
245392,1741,366,67,77,10
199569,1781,366,67,67,0
233105,1772,381,67,67,0
236177,1642,343,67,67,0
239249,1617,344,67,78,11
188305,1655,345,67,67,0
204690,1698,354,67,67,0
234903,1051,368,67,74,7
244887,1712,374,67,74,7
208782,1155,378,67,68,1
213795,1773,370,67,70,3
238885,1585,347,67,72,5
209957,1106,374,67,68,1
228644,1681,336,67,67,0
225060,1579,337,67,67,0
220708,1675,362,67,68,1
204324,1796,389,67,68,1
233763,990,357,67,75,8
239363,1497,321,67,73,6
263200,1697,356,67,67,0
241411,1514,327,67,76,9
179971,1657,366,67,67,0
246787,1647,354,67,80,13
211204,1812,391,67,70,3
221700,1150,374,67,67,0
233476,1672,365,67,76,9
186116,1880,384,67,67,0
240677,1843,388,67,72,5
243749,1651,364,67,68,1
248471,1825,382,67,79,12
246937,1694,377,67,77,10
209816,1584,344,67,69,2
239512,1835,387,67,74,7
239768,1722,381,67,67,0
230297,1408,299,67,67,0
233881,1640,356,67,73,6
239513,1700,375,67,74,7
244889,1746,374,67,75,8
251545,1615,347,67,77,10
262438,1556,342,67,72,5
188313,1789,374,67,67,0
223747,1762,366,67,68,1
236547,1880,394,67,67,0
235814,1803,382,67,67,0
234278,1634,355,67,67,0
234022,1756,362,67,67,0
207910,1471,306,67,67,0
222094,1690,352,67,67,0
234381,1520,338,67,68,1
264311,1502,335,67,83,16
259977,1495,323,67,73,6
245898,1674,368,67,69,2
242058,1670,361,67,70,3
233098,1763,387,67,74,7
226442,1701,371,67,67,0
222346,1509,323,67,67,0
204682,1748,366,67,67,0
263562,1708,347,67,70,3
254601,900,340,67,70,3
208523,1701,367,67,67,0
184457,1745,360,67,67,0
248201,1698,365,67,76,9
236681,1827,387,67,72,5
232329,1626,344,67,73,6
254344,1624,346,67,70,3
252552,1105,377,67,83,16
228232,1206,381,67,67,0
202123,1766,378,67,67,0
234379,1054,354,67,72,5
255111,1846,404,67,81,14
259700,1462,311,67,67,0
256118,1715,368,67,76,9
229494,1425,305,67,67,0
222838,1886,395,67,67,0
145014,1753,365,67,67,0
258165,1647,365,67,77,10
256885,1752,378,67,81,14
240501,1740,375,67,72,5
52340,1589,322,67,67,0
234891,1755,371,67,72,5
210548,1763,351,67,70,3
254579,1710,360,67,77,10
244851,1618,350,67,76,9
213644,1809,382,67,67,0
200076,1219,386,67,68,1
254859,1528,343,67,81,14
251019,1488,336,67,68,1
211848,1897,406,67,67,0
176007,1865,388,67,67,0
231821,1716,360,67,70,3
241281,1747,369,67,75,8
231299,1437,311,67,67,0
225667,1793,372,67,73,6
219779,1740,379,67,67,0
217730,1767,371,67,67,0
201346,1732,364,67,67,0
254849,1592,354,67,81,14
188289,1720,355,67,67,0
232577,1841,392,67,67,0
251011,1785,378,67,72,5
229249,1682,372,67,70,3
163201,1019,364,67,67,0
222081,1809,380,67,68,1
237452,1787,379,67,68,1
182412,1733,359,67,67,0
202893,1757,369,67,67,0
213901,1398,295,67,69,2
246659,1546,333,67,68,1
193411,1158,384,67,67,0
236167,1762,357,67,67,0
245637,1586,346,67,80,13
220807,1089,379,67,75,8
219527,1634,350,67,67,0
255110,1461,326,67,77,10
246406,1390,291,67,70,3
237702,1635,360,67,75,8
235398,1683,376,67,68,1
190597,1869,389,67,68,1
178565,1770,366,67,67,0
215940,1721,375,67,67,0
229765,1682,360,67,67,0
228997,1528,331,67,72,5
228741,1757,393,67,67,0
220805,1688,358,67,67,0
264325,1591,345,67,78,11
260740,1414,308,67,76,9
252036,1575,337,67,77,10
212000,1752,385,67,68,1
251155,1572,349,67,72,5
248863,1704,376,67,72,5
238389,1480,317,67,80,13
225270,1567,334,67,72,5
218614,1830,386,67,68,1
208630,1906,398,67,67,0
208374,1751,373,67,67,0
252917,1768,379,67,78,11
205045,1571,344,67,68,1
208949,1767,365,67,67,0
225077,1780,387,67,72,5
200502,1178,382,67,67,0
251831,1695,359,67,73,6
226102,1506,325,67,67,0
227638,1618,362,67,70,3
244022,1602,356,67,70,3
255286,1424,301,67,68,1
212791,1820,393,67,67,0
225847,1882,398,67,71,4
229175,1710,367,67,70,3
232759,1705,375,67,76,9
259318,1538,327,67,72,5
198903,1685,358,67,67,0
220663,1742,389,67,70,3
226295,1549,323,67,76,9
259322,1561,342,67,74,7
235514,1436,316,67,69,2
235258,1389,302,67,67,0
230687,1590,343,67,72,5
220922,1609,348,67,67,0
201978,1620,349,67,67,0
259065,1045,376,67,81,14
242937,1743,386,67,71,4
193272,1057,364,67,69,2
254200,1823,381,67,67,0
247288,1639,360,67,77,10
230136,1770,380,67,72,5
224504,1732,368,67,70,3
202744,1587,344,67,67,0
200696,1187,381,67,70,3
238071,1665,376,67,79,12
229879,1608,344,67,68,1
242999,1766,363,67,79,12
244023,1663,362,67,73,6
230200,1790,365,67,67,0
260158,1752,371,67,77,10
215615,1890,406,67,67,0
223551,1686,350,67,67,0
243520,1803,392,67,81,14
244288,1523,333,67,79,12
247360,1531,331,67,86,19
193344,1867,400,67,67,0
209729,1703,358,67,68,1
217153,1903,408,67,67,0
220737,1702,355,67,67,0
242753,1726,366,67,78,11
248385,1551,333,67,79,12
197954,1807,373,67,67,0
199490,1863,391,67,67,0
213570,1735,379,67,67,0
226114,1493,346,67,69,2
244034,1732,365,67,74,7
252738,1431,311,67,75,8
202559,1623,334,67,67,0
241726,1773,385,67,76,9
233272,1859,393,67,70,3
175934,1186,374,67,67,0
236344,1701,368,67,77,10
254008,989,363,67,72,5
216377,1541,334,67,67,0
225849,1742,386,67,68,1
211002,1570,333,67,67,0
211514,1757,374,67,67,0
232250,1721,365,67,75,8
251194,1551,338,67,70,3
264251,1653,364,67,72,5
202043,1751,372,67,67,0
236859,1615,343,67,67,0
253755,1584,349,67,85,18
193851,1830,382,67,67,0
221244,1629,355,67,67,0
232252,1717,366,67,75,8
234300,1639,377,67,73,6
250941,1814,391,67,76,9
261626,1687,359,67,72,5
202491,1770,367,67,67,0
211195,1661,357,67,68,1
232635,1633,361,67,71,4
190907,1833,388,67,67,0
259771,1499,321,67,74,7
260283,1814,380,67,72,5
202428,1742,362,67,67,0
204476,1456,306,67,67,0
212156,1661,359,67,67,0
214972,1681,354,67,70,3
231356,1797,396,67,70,3
166844,1715,353,67,67,0
233148,1710,370,67,67,0
183228,1551,321,67,67,0
201149,1429,302,67,67,0
229053,1809,390,67,67,0
238269,1634,355,67,72,5
240829,1722,373,67,73,6
176061,1801,371,67,67,0
244669,1713,377,67,76,9
234683,1643,350,67,76,9
228283,1811,386,67,70,3
189885,1774,375,67,67,0
201403,1769,377,67,67,0
205752,1785,379,67,67,0
220600,1815,367,67,68,1
232376,1817,390,67,67,0
188856,1767,364,67,67,0
124344,1531,313,67,67,0
256952,1741,383,67,71,4
210361,1502,313,67,67,0
224185,1893,389,67,70,3
231353,1591,350,67,71,4
232377,1638,353,67,68,1
243129,1491,317,67,74,7
220090,1525,328,67,67,0
243642,1762,396,67,75,8
246202,1582,352,67,70,3
185018,1855,391,67,67,0
250810,1485,335,67,70,3
262587,1525,334,67,84,17
183741,1828,382,67,67,0
140222,1442,297,67,67,0
211707,1773,381,67,67,0
214067,1550,324,67,67,0
235315,1836,397,67,72,5
252723,1703,355,67,67,0
258356,1450,314,67,73,6
257279,1654,355,67,82,15
237823,1657,369,67,79,12
230399,1740,385,67,67,0
162047,1878,385,67,67,0
239614,1654,358,67,77,10
223230,1687,347,67,67,0
212990,1847,399,67,72,5
248061,1688,367,67,67,0
210941,1156,375,67,67,0
262397,1759,374,67,72,5
235004,1464,307,67,67,0
259835,1593,344,67,67,0
189691,1844,394,67,67,0
242427,1473,322,67,73,6
231219,1700,366,67,72,5
202803,1691,368,67,68,1
223934,1677,358,67,67,0
241970,1461,325,67,67,0
219950,1624,357,67,69,2
199215,1853,390,67,67,0
219951,1834,382,67,72,5
239919,1628,350,67,74,7
247599,1763,379,67,75,8
209456,1688,354,67,67,0
228912,1044,368,67,67,0
230192,1755,369,67,67,0
231472,1580,350,67,72,5
235312,1195,377,67,71,4
224305,1728,364,67,70,3
225073,1653,356,67,67,0
241969,1642,355,67,73,6
251441,1684,368,67,71,4
189233,1116,363,67,67,0
205874,1169,377,67,67,0
235570,1821,396,67,72,5
254786,1630,357,67,77,10
190530,1479,318,67,67,0
258626,1788,376,67,71,4
220624,1238,399,67,72,5
179663,1801,382,67,67,0
235471,1741,369,67,67,0
230351,1841,400,67,67,0
214991,1860,395,67,67,0
258766,1660,356,67,79,12
255438,1572,342,67,80,13
240846,1582,343,67,72,5
220878,1563,343,67,72,5
215758,1794,386,67,70,3
261069,1495,331,67,75,8
188621,1884,386,67,67,0
244941,1825,379,67,70,3
259532,1071,373,67,83,16
183244,1046,375,67,67,0
225996,1744,370,67,67,0
212428,1611,341,67,67,0
237635,1635,351,67,68,1
251599,1765,369,67,74,7
233424,1770,376,67,72,5
232004,1423,307,67,68,1
239568,1451,311,67,67,0
253652,1637,355,67,67,0
237524,1669,362,67,68,1
234196,1831,379,67,72,5
229588,1860,395,67,70,3
224724,1614,357,67,67,0
213204,1737,368,67,67,0
244947,1543,322,67,67,0
224211,1542,346,67,73,6
213203,1522,312,67,67,0
253138,1786,383,67,78,11
248018,1111,380,67,73,6
242386,1451,317,67,76,9
222930,1792,381,67,69,2
258769,1799,384,67,76,9
176849,1709,362,67,67,0
220881,1714,365,67,72,5
243664,1795,382,67,68,1
184387,1870,388,67,67,0
194372,1118,380,67,67,0
226005,1823,390,67,67,0
252488,1698,366,67,80,13
252489,1677,363,67,81,14
193097,1726,366,67,67,0
171082,1918,395,67,67,0
241994,1704,352,67,68,1
213323,1547,331,67,67,0
220491,1609,355,67,67,0
223307,1832,394,67,69,2
202060,1512,327,67,68,1
209484,1693,376,67,67,0
239948,1830,390,67,76,9
244812,1728,367,67,74,7
257612,1587,341,67,79,12
238157,1671,362,67,77,10
174669,1831,374,67,67,0
242253,1576,347,67,74,7
247885,1611,336,67,76,9
254541,1630,361,67,85,18
231753,1790,385,67,73,6
247112,1725,370,67,73,6
184901,1776,375,67,67,0
239944,1813,398,67,68,1
251461,1667,367,67,69,2
252485,1580,353,67,73,6
256325,1502,335,67,79,12
199238,1603,341,67,67,0
210502,1064,368,67,68,1
216134,1654,365,67,67,0
229702,1595,344,67,70,3
251974,1767,384,67,76,9
186950,1831,400,67,67,0
193862,1395,309,67,67,0
155463,1696,353,67,67,0
165191,1754,363,67,67,0
203848,1578,341,67,67,0
212040,1771,378,67,71,4
215112,1665,360,67,71,4
155976,1866,376,67,67,0
230984,1782,372,67,67,0
210389,1735,380,67,68,1
228821,1826,387,67,71,4
199491,1711,360,67,67,0
259569,1685,361,67,79,12
242673,1825,384,67,68,1
229873,1715,376,67,72,5
229361,1834,378,67,70,3
217585,1773,372,67,68,1
201457,1732,369,67,67,0
246256,1723,371,67,72,5
213488,1684,366,67,70,3
234223,1786,389,67,72,5
232431,1796,387,67,67,0
208111,1689,365,67,68,1
177390,1829,375,67,67,0
238830,1564,336,67,67,0
238062,1701,356,67,76,9
231406,1703,363,67,73,6
252141,1882,404,67,75,8
172013,1795,382,67,67,0
223981,1799,386,67,70,3
243185,1515,347,67,72,5
259825,1558,348,67,73,6
214765,1680,363,67,68,1
204786,1693,364,67,67,0
199747,1746,373,67,67,0
196853,1745,372,67,67,0
251636,1699,366,67,74,7
245492,1615,351,67,74,7
244212,1715,375,67,69,2
205300,1668,346,67,67,0
247539,1574,339,67,74,7
239091,1700,378,67,71,4
232691,1421,322,67,67,0
231667,1698,366,67,67,0
226803,1513,338,67,67,0
212467,1502,321,67,68,1
208115,1758,382,67,67,0
190962,1458,323,67,67,0
177138,1812,376,67,67,0
234994,1121,377,67,68,1
211954,1821,389,67,67,0
215533,1098,361,67,69,2
204269,1123,371,67,69,2
236757,1656,362,67,75,8
228568,1759,374,67,69,2
202456,1639,338,67,67,0
250839,1808,377,67,76,9
176599,1749,350,67,67,0
227287,1811,385,67,70,3
199895,1586,328,67,68,1
244694,1565,328,67,76,9
240342,1809,391,67,67,0
234198,1767,387,67,72,5
232406,1704,361,67,69,2
226518,1586,328,67,68,1
220118,1726,361,67,67,0
204502,1040,376,67,71,4
260309,988,357,67,69,2
256725,1601,346,67,86,19
189141,1667,352,67,67,0
243925,954,367,67,70,3
238037,1548,325,67,74,7
211928,1853,389,67,70,3
201446,1759,371,67,67,0
245740,1481,319,67,67,0
153062,1804,364,67,67,0
236268,1705,371,67,67,0
203756,1531,315,67,67,0
238570,989,358,67,76,9
235242,1823,383,67,72,5
248041,1822,396,67,72,5
233961,1803,396,67,74,7
218345,1784,377,67,67,0
264425,1658,367,67,73,6
198377,1838,397,67,67,0
260328,1768,377,67,76,9
189160,1813,386,67,67,0
243944,1566,346,67,70,3
238056,1657,361,67,72,5
260839,1729,381,67,71,4
192231,1841,393,67,67,0
235751,1721,377,67,67,0
256998,1694,358,67,67,0
198328,1529,328,67,67,0
164858,1648,337,67,67,0
241591,1752,378,67,73,6
244827,990,356,67,69,2
213591,1814,389,67,67,0
239703,1761,394,67,68,1
257111,1672,375,67,72,5
264280,1723,380,67,83,16
230232,1682,370,67,67,0
183640,1297,281,67,67,0
256856,1735,373,67,76,9
259928,1497,327,67,72,5
200793,1581,342,67,69,2
227929,1809,384,67,75,8
260953,1761,380,67,72,5
213338,1810,385,67,67,0
150106,1677,346,67,67,0
233050,1828,394,67,77,10
237658,1436,312,67,79,12
221531,1173,374,67,70,3
224859,1709,366,67,72,5
205655,1446,308,67,68,1
242774,1030,362,67,75,8
215638,1480,315,67,72,5
234580,1615,349,67,67,0
250962,1839,398,67,70,3
203603,1904,396,67,67,0
240211,1778,381,67,68,1
185171,1751,359,67,67,0
210772,1076,356,67,69,2
223572,1662,357,67,71,4
163156,1572,334,67,67,0
196436,1780,373,67,67,0
210006,1168,376,67,68,1
158293,1794,357,67,67,0
229973,1814,396,67,72,5
230485,1698,356,67,67,0
248661,1660,360,67,78,11
256341,1747,372,67,82,15
257877,1652,348,67,78,11
203862,1729,373,67,67,0
227675,1790,388,67,67,0
246107,1742,362,67,82,15
236508,1505,323,67,73,6
237797,1828,393,67,67,0
222944,1802,379,67,67,0
252383,1853,399,67,76,9
251615,1702,367,67,78,11
245983,1706,373,67,68,1
178143,1159,377,67,67,0
230623,1485,309,67,68,1
200671,1787,362,67,67,0
194014,1733,375,67,67,0
242654,1594,355,67,79,12
235486,1722,366,67,67,0
211166,1500,330,67,72,5
205278,1665,375,67,67,0
255197,1750,379,67,68,1
237789,1605,343,67,68,1
230365,1778,381,67,67,0
209885,1835,405,67,67,0
189148,1803,374,67,67,0
227040,1672,351,67,71,4
247264,1545,338,67,75,8
253920,1631,340,67,67,0
245732,1673,364,67,76,9
233957,1749,371,67,75,8
212453,1189,363,67,69,2
258276,1672,359,67,70,3
190180,1732,373,67,67,0
254692,1524,338,67,76,9
187620,1418,296,67,67,0
185316,1484,310,67,67,0
198628,1746,369,67,67,0
262881,1712,379,67,76,9
245219,1520,326,67,68,1
247266,1450,320,67,71,4
245218,1768,377,67,73,6
171490,1133,364,67,67,0
226786,1173,374,67,67,0
193505,1766,377,67,67,0
238049,1841,389,67,80,13
246866,1779,376,67,77,10
226386,1588,353,67,69,2
223826,1472,323,67,67,0
199762,1860,390,67,67,0
241507,1456,330,67,75,8
232803,1666,349,67,68,1
256098,1727,364,67,81,14
240226,1639,345,67,71,4
222306,1815,387,67,67,0
219746,1750,381,67,67,0
215650,1671,362,67,67,0
262498,1788,374,67,74,7
233569,1735,360,67,67,0
228961,1837,392,67,67,0
219489,1672,362,67,67,0
189536,1738,347,67,67,0
189024,1063,368,67,67,0
251232,1687,362,67,72,5
238944,1788,378,67,67,0
229728,1760,378,67,70,3
229472,1814,385,67,71,4
252259,1724,358,67,79,12
238692,1681,349,67,67,0
176996,1707,366,67,67,0
202855,1771,379,67,67,0
186984,1452,322,67,67,0
247912,1748,376,67,77,10
243304,987,358,67,75,8
251751,1546,331,67,74,7
237415,1611,360,67,77,10
226151,1514,331,67,72,5
211047,1697,361,67,67,0
200807,1742,378,67,67,0
242533,1457,320,67,70,3
255590,1780,377,67,72,5
254566,1741,385,67,82,15
247142,1796,384,67,67,0
236390,1708,379,67,71,4
231014,1715,383,67,74,7
209510,1629,354,67,68,1
259173,1359,296,67,78,11
225632,1743,388,67,72,5
258655,1871,393,67,70,3
237407,1813,382,67,76,9
243123,1652,350,67,67,0
182096,1755,379,67,67,0
189776,1687,365,67,67,0
256080,1684,364,67,79,12
208977,1809,389,67,67,0
241745,1476,329,67,67,0
246097,1628,352,67,74,7
236467,1678,358,67,76,9
254131,1730,371,67,79,12
225872,1849,395,67,72,5
259251,1503,329,67,69,2
222645,1776,371,67,69,2
227509,1704,375,67,69,2
230325,1437,313,67,67,0
235957,1763,377,67,71,4
237749,1793,388,67,73,6
256849,1669,358,67,73,6
227920,1558,345,67,75,8
260377,1804,388,67,75,8
221791,1819,374,67,67,0
182621,1615,330,67,67,0
203615,1837,380,67,68,1
198751,1815,393,67,67,0
257118,1644,341,67,76,9
244318,1796,383,67,70,3
206430,1686,359,67,68,1
199262,1906,398,67,67,0
251229,1668,367,67,77,10
243549,1521,325,67,71,4
262426,1419,300,67,73,6
239709,1658,353,67,72,5
232541,1765,389,67,67,0
224093,1671,365,67,71,4
238775,1708,360,67,73,6
209769,1838,383,67,68,1
223850,1690,376,67,70,3
206106,1722,369,67,67,0
242908,1613,346,67,80,13
238563,1677,366,67,67,0
257831,1697,370,67,76,9
203357,1637,361,67,68,1
255580,1667,364,67,77,10
239642,1679,368,67,73,6
246298,1588,342,67,72,5
248602,1534,339,67,76,9
254234,1545,331,67,67,0
190490,1652,371,67,67,0
256282,1678,364,67,67,0
200475,1650,354,67,67,0
241179,987,355,67,76,9
243995,1706,373,67,75,8
222798,1810,393,67,67,0
239438,1539,340,67,71,4
191566,1833,378,67,67,0
259406,1640,360,67,83,16
201295,1767,364,67,67,0
204367,1148,368,67,68,1
211791,1767,380,67,67,0
214351,1118,390,67,67,0
224335,1707,367,67,68,1
190747,1650,347,67,67,0
232527,1554,335,67,68,1
171087,1797,375,67,67,0
241999,1473,320,67,69,2
244559,1661,361,67,73,6
213328,1756,368,67,72,5
183644,1871,388,67,67,0
232284,1090,369,67,78,11
226652,1780,379,67,67,0
204380,1182,387,67,70,3
202077,1686,355,67,67,0
208989,1615,357,67,67,0
194907,1915,400,67,67,0
222045,1736,362,67,69,2
260138,1712,370,67,76,9
188202,1092,372,67,67,0
230187,1784,367,67,67,0
244266,1583,350,67,70,3
238379,1785,390,67,78,11
262956,1055,358,67,71,4
234282,1576,356,67,69,2
223018,1662,368,67,67,0
248105,1630,340,67,75,8
246057,1789,383,67,75,8
232489,1823,382,67,67,0
220201,1645,347,67,70,3
257320,1782,383,67,79,12
183336,1804,379,67,67,0
241704,1699,365,67,71,4
231464,1651,368,67,70,3
222248,1825,393,67,67,0
201512,1737,372,67,67,0
258599,1504,328,67,70,3
210476,1061,360,67,69,2
251431,1689,372,67,76,9
245287,1770,381,67,77,10
238375,1662,363,67,68,1
234279,1842,389,67,67,0
226087,1691,362,67,68,1
208679,1097,359,67,67,0
258598,1640,360,67,74,7
255526,1790,382,67,72,5
240940,1562,336,67,78,11
202076,1739,376,67,67,0
238940,1589,350,67,67,0
253144,1521,334,67,70,3
260652,1682,356,67,67,0
261661,1875,400,67,72,5
211742,1846,389,67,67,0
234014,1701,343,67,67,0
245022,1514,335,67,71,4
246814,1756,367,67,82,15
248862,1633,360,67,74,7
254238,1602,361,67,71,4
253400,1525,332,67,74,7
194092,1855,393,67,67,0
203309,1711,376,67,67,0
255005,1748,378,67,71,4
212013,1766,373,67,67,0
229677,1762,379,67,69,2
234029,1607,339,67,67,0
214318,1715,372,67,68,1
243125,1626,360,67,67,0
262582,1698,365,67,77,10
241590,1457,328,67,78,11
199351,1782,368,67,67,0
231863,1720,363,67,75,8
259101,1775,372,67,73,6
252716,1657,357,67,68,1
206109,1815,387,67,67,0
229851,1472,317,67,67,0
248092,1507,334,67,67,0
259800,1605,340,67,67,0
221657,1629,361,67,67,0
229337,1724,360,67,75,8
242393,1741,378,67,74,7
176346,1835,376,67,67,0
247258,1801,387,67,75,8
257242,1722,378,67,70,3
259802,1534,349,67,69,2
209371,1763,371,67,67,0
226523,1546,339,67,70,3
190424,1720,347,67,67,0
262620,1666,361,67,68,1
173531,1134,381,67,67,0
240859,1572,330,67,81,14
247771,1756,380,67,77,10
257243,1796,386,67,71,4
230172,1100,342,67,69,2
234834,1530,336,66,68,2
246865,1595,345,66,75,9
257361,1597,351,66,76,10
259921,1671,357,66,69,3
204882,1856,391,66,66,0
233298,1602,363,66,66,0
234066,1830,391,66,80,14
246048,1505,326,66,78,12
237138,1674,353,66,71,5
225368,1491,330,66,68,2
244050,1760,392,66,77,11
247378,1743,366,66,66,0
232768,1701,356,66,66,0
184664,1546,318,66,66,0
213849,1683,353,66,66,0
176472,1527,321,66,66,0
241743,1824,380,66,66,0
239191,1540,331,66,70,4
235855,1613,354,66,73,7
240207,1708,376,66,68,2
193312,1150,368,66,66,0
210000,1894,403,66,66,0
233040,1747,383,66,71,5
169808,1870,389,66,66,0
206161,1780,375,66,66,0
224337,1692,364,66,66,0
242769,1608,352,66,77,11
244800,1747,386,66,69,3
209954,1830,387,66,66,0
198178,1609,349,66,66,0
190497,1736,364,66,66,0
255265,1554,343,66,71,5
238656,1618,355,66,73,7
258885,921,363,66,78,12
263489,1698,372,66,68,2
239443,1644,357,66,73,7
201035,1171,376,66,67,1
229707,1667,360,66,71,5
186450,1591,348,66,66,0
187218,1060,367,66,66,0
209491,1467,322,66,66,0
230995,1751,382,66,70,4
236883,1856,406,66,72,6
245849,1490,335,66,75,9
262986,1739,367,66,75,9
242003,1679,360,66,75,9
214356,1422,311,66,68,2
240468,1667,359,66,75,9
244052,1787,373,66,76,10
187988,1636,319,66,66,0
257620,1663,357,66,67,1
192596,1506,322,66,66,0
247882,960,365,66,74,8
255561,1766,381,66,79,13
244565,1806,387,66,76,10
251464,1657,374,66,82,16
239686,1649,366,66,70,4
253254,1735,372,66,75,9
232007,926,355,66,73,7
214088,1170,384,66,70,4
241736,1461,325,66,79,13
241992,1665,359,66,71,5
244040,1547,334,66,66,0
253256,1788,386,66,79,13
250953,1534,337,66,66,0
192840,1556,332,66,66,0
262985,1621,345,66,74,8
211785,1796,379,66,67,1
213321,1734,370,66,66,0
232521,1299,293,66,71,5
236617,1802,381,66,71,5
240969,1626,349,66,75,9
232533,1067,354,66,66,0
246613,1582,357,66,75,9
210241,1716,380,66,66,0
219458,1779,380,66,66,0
206147,1719,374,66,66,0
205894,1179,379,66,67,1
202819,1859,388,66,66,0
260674,1617,338,66,66,0
253250,1714,379,66,76,10
242242,1024,362,66,72,6
233794,1634,337,66,71,5
206402,1230,375,66,66,0
252483,1625,364,66,76,10
200770,1893,400,66,66,0
192321,1877,386,66,66,0
257345,1801,389,66,83,17
256065,1649,366,66,73,7
241217,933,350,66,72,6
234049,926,355,66,73,7
232513,1742,358,66,66,0
232515,1623,355,66,66,0
205892,1662,362,66,66,0
254789,1747,377,66,78,12
243525,1783,377,66,75,9
224854,1440,313,66,67,1
241494,1444,325,66,74,8
181846,1855,390,66,66,0
200535,1846,386,66,67,1
221271,1653,351,66,67,1
224855,1728,368,66,69,3
245573,1600,349,66,74,8
240453,1542,344,66,75,9
236868,1665,355,66,76,10
229701,1850,391,66,73,7
202053,1595,346,66,66,0
258116,1520,332,66,73,7
191556,1774,352,66,66,0
188996,1629,342,66,66,0
246340,1547,352,66,76,10
240196,1618,346,66,71,5
215129,1825,393,66,66,0
228668,1697,350,66,66,0
182617,1727,363,66,66,0
229998,1679,364,66,70,4
233068,1693,361,66,66,0
260971,1600,350,66,74,8
257899,1610,339,66,76,10
253547,1697,369,66,66,0
224875,1730,382,66,70,4
182122,1767,377,66,66,0
223594,1526,327,66,68,2
263529,1585,337,66,71,5
192616,1679,343,66,66,0
257896,1705,376,66,80,14
256616,1632,358,66,76,10
189544,1516,319,66,66,0
251240,1712,365,66,66,0
203368,1758,366,66,66,0
262504,1539,343,66,72,6
254055,1818,386,66,66,0
231527,1652,357,66,73,7
170342,1295,268,66,66,0
227686,1746,375,66,67,1
205158,1728,365,66,66,0
200806,1737,359,66,66,0
239724,1387,295,66,66,0
190060,1840,395,66,66,0
190572,1804,372,66,66,0
253807,1521,330,66,66,0
238958,1816,385,66,75,9
242542,1624,355,66,73,7
246126,1672,359,66,77,11
262255,1557,353,66,74,8
209007,1711,360,66,66,0
235375,933,347,66,69,3
246127,1763,379,66,75,9
252015,1569,343,66,71,5
253295,1767,377,66,74,8
189551,1626,338,66,66,0
204397,1530,341,66,66,0
198000,1833,385,66,66,0
208752,1474,318,66,67,1
234016,1685,353,66,66,0
201326,1786,358,66,66,0
263790,1594,351,66,78,12
194925,1687,347,66,66,0
239981,1534,327,66,77,11
223853,1764,372,66,69,3
210029,1673,354,66,67,1
241765,1630,361,66,69,3
240997,1464,312,66,77,11
158309,1858,389,66,66,0
239181,1604,344,66,69,3
222528,1822,394,66,68,2
232000,1601,339,66,71,5
158543,1757,355,66,66,0
213327,1395,308,66,66,0
263759,1737,381,66,83,17
244558,1597,343,66,77,11
240206,1782,380,66,66,0
208974,1747,376,66,66,0
246093,1636,341,66,67,1
151885,1062,363,66,66,0
263232,932,354,66,70,4
251212,1683,371,66,66,0
107084,1050,354,66,66,0
233804,1777,388,66,75,9
230220,1693,340,66,66,0
221772,1693,362,66,66,0
261195,1600,344,66,74,8
255307,1746,373,66,73,7
241995,1567,342,66,72,6
239179,1670,363,66,68,2
203328,1814,387,66,66,0
243519,1756,378,66,75,9
220517,1630,349,66,69,3
237667,1597,341,66,66,0
260708,1695,369,66,75,9
253796,1603,354,66,77,11
243556,1492,334,66,66,0
220772,1760,368,66,67,1
211556,1472,310,66,66,0
210020,1816,388,66,67,1
262500,1748,366,66,76,10
195427,1596,341,66,66,0
258147,1643,360,66,82,16
235095,1647,354,66,73,7
219967,1026,361,66,71,5
261436,1628,347,66,74,8
203069,1827,393,66,66,0
254525,1642,354,66,74,8
255037,1820,390,66,71,5
203838,1716,358,66,66,0
211262,1138,372,66,66,0
244798,1769,379,66,72,6
261182,1612,344,66,73,7
218175,1054,372,66,66,0
238190,1782,391,66,76,10
237884,1694,369,66,73,7
187225,1623,347,66,66,0
233276,1831,390,66,73,7
233309,1696,366,66,72,6
235101,1744,377,66,72,6
242525,1674,363,66,73,7
182365,1059,363,66,66,0
260189,1715,362,66,66,0
224094,1630,357,66,70,4
240734,1721,370,66,74,8
183646,1084,373,66,66,0
185438,1728,366,66,66,0
215647,1548,339,66,66,0
234079,1719,377,66,69,3
244319,1562,340,66,70,4
245855,1766,377,66,72,6
181343,1788,369,66,66,0
247391,1670,367,66,72,6
218976,1590,351,66,66,0
252512,1490,322,66,78,12
209761,1483,306,66,66,0
212065,1609,347,66,66,0
240481,1620,345,66,76,10
247649,1417,313,66,84,18
231005,1740,389,66,72,6
204637,1654,358,66,66,0
200797,1778,374,66,66,0
226395,1623,349,66,66,0
216666,1399,294,66,66,0
152922,1820,365,66,66,0
236378,1082,370,66,79,13
238682,1793,376,66,66,0
186970,1562,358,66,66,0
253786,1398,306,66,70,4
262491,1592,344,66,66,0
198235,1685,355,66,66,0
156507,1270,370,66,66,0
238683,1584,358,66,71,5
197981,1497,312,66,66,0
199772,1800,384,66,66,0
233564,1613,341,66,68,2
233820,1674,363,66,73,7
237916,1778,368,66,77,11
238684,1695,370,66,68,2
176732,1463,300,66,66,0
246108,1579,342,66,76,10
184156,1830,385,66,66,0
191068,1605,349,66,66,0
193889,1090,366,66,66,0
213858,1473,311,66,66,0
214114,1845,396,66,66,0
240697,1766,383,66,75,9
171831,1639,357,66,66,0
247351,1683,363,66,82,16
187447,1875,377,66,66,0
258359,1764,382,66,74,8
229176,1767,376,66,74,8
235320,1652,361,66,66,0
242744,1782,387,66,77,11
261176,1542,324,66,80,14
211001,1589,336,66,66,0
258361,1458,334,66,72,6
242486,1617,350,66,69,3
209210,1445,309,66,66,0
218938,1422,295,66,66,0
234298,1823,390,66,66,0
239930,1740,380,66,69,3
241210,1048,365,66,71,5
243514,1654,364,66,76,10
251195,1567,344,66,71,5
208188,1526,329,66,66,0
221756,1690,355,66,67,1
199735,1619,343,66,66,0
239926,1836,395,66,70,4
231266,1724,364,66,75,9
244786,1397,295,66,67,1
241506,1569,339,66,74,8
255586,1850,394,66,70,4
227377,1374,291,66,66,0
254257,1678,346,66,72,6
201522,1790,392,66,66,0
212018,1527,330,66,66,0
216114,1602,346,66,73,7
223794,1787,383,66,66,0
230450,1705,356,66,66,0
245810,1447,318,66,73,7
206134,1592,355,66,68,2
253490,1668,369,66,76,10
237619,1836,385,66,75,9
247091,1687,367,66,77,11
203060,1868,396,66,66,0
219956,1538,340,66,69,3
214837,1568,334,66,66,0
187701,1767,373,66,66,0
253237,1727,376,66,70,4
255285,1351,289,66,66,0
236832,1693,372,66,68,2
221631,1751,375,66,67,1
218656,1544,343,66,66,0
192008,1725,376,66,66,0
239624,1621,353,66,73,7
222472,1708,365,66,69,3
200200,1547,320,66,66,0
259847,1663,356,66,70,4
169479,1687,357,66,66,0
227847,1574,348,66,68,2
260358,1502,321,66,69,3
230150,1728,361,66,66,0
225798,1639,360,66,69,3
240133,1556,322,66,66,0
236037,1796,374,66,71,5
220677,1712,359,66,71,5
260356,1828,384,66,67,1
190724,1682,362,66,66,0
242692,1758,378,66,66,0
240648,1679,369,66,75,9
238089,1698,377,66,72,6
212484,1777,388,66,67,1
205834,1720,362,66,66,0
212237,1738,362,66,67,1
254220,1519,339,66,72,6
220940,1867,390,66,70,4
194059,1800,372,66,66,0
187915,1493,307,66,66,0
184843,1692,351,66,66,0
238091,1739,370,66,77,11
172555,1709,361,66,66,0
236043,1799,383,66,73,7
211211,1629,351,66,66,0
207627,1400,298,66,66,0
260874,1494,328,66,76,10
244490,1511,334,66,74,8
233226,1553,340,66,68,2
224010,1167,380,66,72,6
240132,1769,380,66,67,1
259331,1735,372,66,79,13
209166,1134,374,66,66,0
258168,1668,375,66,80,14
237176,925,355,66,75,9
222328,1559,339,66,71,5
216440,1667,357,66,66,0
204664,1714,364,66,66,0
198264,1669,345,66,66,0
197496,1116,359,66,66,0
255351,1731,370,66,80,14
247159,1650,355,66,77,11
245367,1793,378,66,83,17
232311,1785,389,66,71,5
228983,1449,329,66,72,6
198519,1797,380,66,66,0
246390,1563,350,66,67,1
233078,1528,329,66,72,6
202102,1888,395,66,66,0
184696,1759,371,66,66,0
202617,1250,381,66,66,0
259075,1742,373,66,81,15
222329,1708,376,66,68,2
236803,1546,347,66,69,3
222979,1656,360,66,67,1
221955,1537,324,66,73,7
211203,1707,363,66,67,1
258306,1599,354,66,71,5
189186,1831,382,66,66,0
223355,1883,397,66,66,0
214395,1584,342,66,66,0
221050,1779,370,66,66,0
212090,1479,343,66,70,4
252025,1786,376,66,81,15
251769,1614,356,66,74,8
244601,1661,355,66,75,9
169593,1793,370,66,66,0
232057,1636,345,66,69,3
179725,1538,337,66,66,0
239118,1498,327,66,67,1
264310,1746,365,66,66,0
213444,1693,356,66,68,2
248259,1649,353,66,75,9
241859,923,355,66,76,10
259778,1595,339,66,71,5
248002,1548,328,66,66,0
237762,1782,356,66,66,0
233154,1128,380,66,66,0
232130,1524,338,66,66,0
259521,1648,355,66,80,14
243393,1769,383,66,78,12
263617,1743,376,66,77,11
243904,1604,339,66,76,10
241344,1759,374,66,71,5
240576,1706,355,66,67,1
231872,1552,330,66,72,6
157888,1122,374,66,66,0
259779,1518,317,66,66,0
237252,1616,360,66,66,0
260543,1624,352,66,75,9
242628,1664,371,66,79,13
259782,1636,363,66,66,0
255942,1456,316,66,67,1
227526,1588,341,66,69,3
225734,1775,394,66,67,1
218054,1629,359,66,67,1
216518,975,352,66,68,2
202182,1784,372,66,66,0
248005,1640,350,66,69,3
242117,1600,348,66,71,5
241605,1785,378,66,66,0
233413,1600,348,66,71,5
232645,1097,369,66,74,8
155589,1726,357,66,66,0
264389,1380,309,66,72,6
259012,1661,353,66,67,1
221632,1776,385,66,66,0
257471,1593,343,66,71,5
197391,1838,382,66,66,0
243456,1703,367,66,69,3
238336,1747,387,66,76,10
233216,1587,351,66,72,6
231424,1803,384,66,67,1
222993,1644,356,66,66,0
207633,1198,380,66,67,1
200209,1148,372,66,67,1
251152,1447,306,66,66,0
184336,1749,376,66,66,0
237328,1597,354,66,78,12
220944,1177,367,66,72,6
199440,1430,315,66,66,0
259087,1578,343,66,83,17
186127,1725,358,66,66,0
242703,1070,353,66,71,5
231951,1828,395,66,72,6
239104,1531,342,66,67,1
244736,1562,341,66,66,0
245439,1639,357,66,73,7
247040,1614,347,66,75,9
179903,1901,398,66,66,0
230079,1675,360,66,69,3
229055,1780,381,66,66,0
262335,1632,353,66,76,10
258494,1628,338,66,80,14
253630,1111,364,66,74,8
184254,995,363,66,66,0
237826,1810,393,66,71,5
235266,933,358,66,76,10
225026,1615,351,66,71,5
202754,1759,371,66,66,0
196353,1777,366,66,66,0
248833,1563,337,66,66,0
245249,1771,380,66,73,7
165889,1769,351,66,66,0
201078,1732,370,66,66,0
203637,1560,350,66,66,0
246727,1603,359,66,67,1
211619,1519,332,66,66,0
187042,1914,397,66,66,0
213922,1591,338,66,66,0
203426,1859,388,66,66,0
262562,1360,299,66,76,10
258465,1776,380,66,78,12
182689,1797,366,66,66,0
167841,1850,377,66,66,0
230561,1737,393,66,73,7
221857,1866,388,66,66,0
214177,1741,372,66,66,0
211617,1755,383,66,66,0
209569,1806,378,66,66,0
228768,1642,351,66,72,6
216736,1925,406,66,68,2
246687,1692,353,66,66,0
209315,1737,370,66,67,1
225955,1519,329,66,71,5
228255,1013,359,66,73,7
232611,1667,368,66,69,3
221620,1799,389,66,67,1
237747,1809,389,66,66,0
235955,1593,334,66,77,11
232627,1631,341,66,66,0
225715,1752,370,66,66,0
222643,1382,286,66,69,3
204979,1785,383,66,68,2
259249,1695,363,66,86,20
253617,1701,367,66,75,9
228017,1679,358,66,72,6
220593,1082,368,66,69,3
244912,1024,356,66,66,0
223908,1670,367,66,68,2
170915,1833,369,66,66,0
234147,1582,345,66,75,9
233887,1653,356,66,71,5
213407,1089,368,66,69,3
253364,1661,364,66,67,1
232603,1419,315,66,70,4
219803,1763,385,66,69,3
198811,1729,359,66,67,1
262299,1620,355,66,69,3
255386,1786,380,66,74,8
242330,1522,321,66,66,0
241562,1552,337,66,77,11
240026,1760,372,66,73,7
239770,1656,356,66,76,10
237210,1865,386,66,68,2
229530,1064,369,66,69,3
228762,1746,374,66,72,6
201114,1705,361,66,66,0
193177,1779,379,66,66,0
237721,1683,363,66,73,7
230809,1709,372,66,72,6
221595,1542,313,66,66,0
235419,1757,366,66,66,0
188062,1777,384,66,66,0
250779,1530,352,66,74,8
242334,1673,371,66,78,12
241566,1728,373,66,72,6
230046,1629,346,66,69,3
227998,1652,363,66,66,0
223134,1810,375,66,66,0
221854,1766,384,66,66,0
217758,1691,367,66,66,0
178589,1789,379,66,66,0
238749,1398,293,66,75,9
224925,1628,341,66,71,5
221853,1759,388,66,66,0
190620,1723,366,66,66,0
251036,988,355,66,77,11
243612,1599,360,66,79,13
222620,1760,375,66,66,0
247476,1712,380,66,72,6
259252,1453,310,66,74,8
200309,1735,388,66,66,0
246385,1678,380,66,75,9
224881,1573,334,66,66,0
217201,1658,333,66,66,0
211825,1821,382,66,66,0
205681,1598,349,66,66,0
259184,1770,374,66,76,10
192624,1813,385,66,66,0
243312,1754,371,66,75,9
236400,1552,336,66,73,7
209264,1714,352,66,67,1
179646,1734,362,66,66,0
244158,1702,372,66,67,1
235966,1457,316,66,73,7
232382,1699,361,66,66,0
210366,1105,364,66,66,0
203966,1727,366,66,66,0
229745,1653,367,66,73,7
187761,1710,349,66,66,0
258493,1667,364,66,79,13
260209,1828,391,66,67,1
263029,1661,359,66,71,5
244340,988,370,66,76,10
233588,1545,323,66,68,2
231540,1512,329,66,73,7
211828,1494,337,66,66,0
210804,1559,321,66,66,0
261491,1576,345,66,67,1
254835,1617,350,66,69,3
247667,1666,362,66,78,12
239219,1787,384,66,67,1
226675,1005,347,66,69,3
225395,1133,372,66,71,5
198003,1667,357,66,66,0
236914,1499,321,66,75,9
220786,1590,354,66,69,3
259773,1490,323,66,72,6
253629,1057,363,66,73,7
199861,1808,373,66,66,0
243641,1707,363,66,72,6
215993,1759,375,66,66,0
201401,1714,372,66,66,0
263609,1559,349,66,66,0
260024,1517,346,66,66,0
252088,1733,370,66,73,7
239800,1548,341,66,80,14
253879,1756,373,66,66,0
230070,1643,354,66,76,10
209334,1733,366,66,66,0
202422,1818,380,66,66,0
260021,929,356,66,66,0
251829,1583,346,66,80,14
232117,1648,362,66,71,5
231093,1451,314,66,66,0
223925,1058,366,66,69,3
224953,1159,381,66,72,6
246457,1647,362,66,76,10
250813,1507,316,66,79,13
235194,1571,344,66,74,8
235197,1649,350,66,73,7
234941,1697,373,66,72,6
232636,1590,343,66,71,5
232380,1798,376,66,66,0
213692,1699,349,66,70,4
210108,1755,369,66,69,3
204220,1846,376,66,67,1
193211,1765,370,66,66,0
189115,1641,363,66,66,0
246203,1626,352,66,75,9
178363,1096,378,66,66,0
238779,1368,305,66,70,4
258746,1645,362,66,72,6
243386,1589,350,66,78,12
237498,1593,336,66,78,12
197831,1708,367,66,66,0
251335,1625,359,66,74,8
223263,1601,362,66,66,0
227878,1766,377,66,71,5
203558,1797,379,66,66,0
250917,1647,363,66,67,1
248869,1630,362,66,75,9
246309,1842,379,66,72,6
246053,1630,356,66,82,16
239397,1706,374,66,72,6
220197,1704,369,66,73,7
228388,1806,389,66,67,1
262436,1665,351,66,66,0
255779,1657,365,66,76,10
173859,1740,360,66,66,0
208675,1786,380,66,67,1
189730,1742,367,66,66,0
179746,1706,346,66,66,0
235554,1729,372,66,72,6
205862,1797,375,66,66,0
235558,1700,361,66,72,6
254603,1542,332,66,71,5
252454,1443,310,66,77,11
240170,940,359,66,78,12
236586,1813,390,66,75,9
233258,1708,376,66,72,6
222506,1781,380,66,66,0
253225,1575,347,66,80,14
248873,1543,338,66,75,9
201257,1898,392,66,66,0
199465,1597,344,66,66,0
252200,965,357,66,73,7
246056,1788,375,66,66,0
205352,1117,373,66,68,2
199464,1606,358,66,67,1
260647,1785,375,66,66,0
247335,1567,329,66,77,11
257318,1651,342,66,81,15
229516,1746,378,66,71,5
238987,1523,335,66,72,6
236587,1637,353,66,74,8
209285,1558,341,66,69,3
191108,1800,381,66,66,0
255876,1734,375,66,74,8
188292,1548,346,66,66,0
247428,946,355,66,76,10
240260,1623,358,66,69,3
238980,1700,374,66,73,7
235652,995,356,66,74,8
225924,1625,350,66,66,0
224388,1501,321,66,73,7
230787,1137,367,66,75,9
223107,959,351,66,66,0
252802,1647,364,66,81,15
215170,1528,319,66,66,0
213634,1628,349,66,70,4
253825,1842,378,66,72,6
258180,1000,352,66,76,10
219781,1744,372,66,68,2
234635,1744,381,66,69,3
238725,1681,367,66,70,4
234123,1613,350,66,69,3
166539,1676,367,66,69,3
257162,1591,346,66,79,13
239498,1769,385,66,68,2
208778,1069,371,66,66,0
189833,1658,358,66,66,0
219529,1336,285,66,68,2
205961,1725,360,66,66,0
237704,1012,380,66,78,12
223880,1435,314,66,68,2
225927,1752,374,66,67,1
220039,1731,371,66,70,4
202375,1906,393,66,66,0
255365,1762,387,66,77,11
244869,1597,349,66,66,0
206123,1652,345,66,66,0
246827,1623,359,66,75,9
216449,1756,370,66,69,3
261146,1736,373,66,74,8
237594,1436,305,66,67,1
169498,1818,373,66,66,0
210970,1773,391,66,66,0
204826,1502,307,66,66,0
260121,1641,355,66,77,11
256281,1635,364,66,73,7
235033,1539,340,66,66,0
228632,1777,396,66,66,0
186135,1709,356,66,66,0
213271,1791,393,66,67,1
263191,1481,319,66,68,2
259094,1608,340,66,71,5
246550,1647,359,66,77,11
224790,1460,314,66,66,0
258325,1654,356,66,66,0
240922,1605,342,66,74,8
207899,1201,379,66,68,2
256788,1648,357,66,77,11
229915,1568,345,66,66,0
149791,1702,339,66,66,0
255773,1524,320,66,70,4
250909,1614,356,66,68,2
245277,1855,388,66,76,10
241693,1665,360,66,75,9
240925,1585,350,66,77,11
236829,1573,334,66,73,7
193564,1744,363,66,66,0
242716,1672,361,66,71,5
227868,1696,363,66,67,1
225564,1778,373,66,70,4
208668,1667,359,66,69,3
205596,1742,368,66,66,0
256539,1378,304,66,73,7
248603,1474,324,66,76,10
200981,1755,380,66,66,0
252436,1694,353,66,73,7
194091,1827,376,66,66,0
248111,1864,393,66,67,1
238895,1754,381,66,69,3
230447,1608,330,66,66,0
217647,1706,359,66,66,0
217391,1637,355,66,66,0
215855,1712,367,66,68,2
214319,1546,324,66,66,0
214063,1681,348,66,66,0
248110,1735,375,66,70,4
221486,1541,333,66,69,3
204078,1690,342,66,66,0
197166,1764,377,66,66,0
252461,1462,314,66,66,0
251436,1721,349,66,81,15
224300,1704,362,66,68,2
260139,1500,320,66,73,7
241967,1717,388,66,69,3
252463,1689,359,66,83,17
242708,1686,365,66,71,5
225584,1834,382,66,66,0
226580,1653,359,66,72,6
224020,1584,345,66,66,0
251923,1646,352,66,66,0
239379,1668,356,66,78,12
236307,1599,339,66,68,2
235027,1199,385,66,74,8
228627,1861,393,66,66,0
255505,1706,371,66,68,2
239377,1563,343,66,79,13
238865,1447,312,66,69,3
228369,1050,358,66,73,7
227601,1766,372,66,73,7
201265,1584,342,66,66,0
255536,1410,305,66,75,9
240176,1399,293,66,66,0
243841,1850,395,66,66,0
209281,1648,334,66,66,0
253895,1727,368,66,66,0
224662,1704,373,66,70,4
233109,1576,344,66,68,2
232597,1744,369,66,66,0
227477,1178,374,66,72,6
257172,1506,341,66,73,7
243604,1615,340,66,78,12
193427,1807,384,66,66,0
247187,1667,367,66,74,8
202131,1782,387,66,68,2
193426,1774,369,66,66,0
239762,1614,359,66,68,2
251025,1755,382,66,74,8
248465,1679,356,66,82,16
244881,1749,378,66,77,11
230801,1688,366,66,68,2
226705,1670,361,66,70,4
224150,1773,380,66,66,0
193942,1752,366,66,66,0
247696,1696,365,66,68,2
226711,1722,361,66,66,0
234148,1782,378,66,68,2
230308,1622,349,66,66,0
193688,1621,334,66,66,0
251800,1730,381,66,73,7
251288,1631,366,66,74,8
233880,1630,359,66,73,7
204184,1708,360,66,66,0
201112,999,358,66,67,1
261015,1792,376,66,80,14
260247,1662,374,66,84,18
258455,1721,372,66,67,1
238743,1549,349,66,74,8
169623,1406,301,66,66,0
233879,1745,358,66,66,0
230807,1617,356,66,74,8
263825,1599,338,66,79,13
246416,1608,343,66,78,12
188836,1160,366,66,66,0
213133,1604,337,66,66,0
199053,1647,348,66,66,0
198285,1085,367,66,68,2
254860,1576,342,66,83,17
244364,947,353,66,76,10
237708,1595,348,66,76,10
228810,1722,378,66,67,1
187337,1749,371,66,66,0
237769,1665,357,66,70,4
216265,1578,346,66,68,2
213449,1722,382,66,69,3
191944,1872,383,66,66,0
238536,1614,348,66,82,16
237768,1798,380,66,66,0
172232,1679,352,66,66,0
231624,1648,359,66,66,0
201869,1764,369,66,66,0
223629,1643,357,66,66,0
243856,1705,367,66,66,0
232589,1698,365,66,66,0
232848,1544,329,66,66,0
211600,1759,393,66,67,1
210832,1083,363,66,69,3
202896,1742,377,66,66,0
263056,1647,349,66,74,8
241551,1673,362,66,71,5
230287,1643,338,66,66,0
250766,1869,391,66,81,15
222350,1733,374,66,66,0
214414,1737,377,66,67,1
212366,1854,393,66,69,3
263566,1599,350,66,74,8
193421,1768,364,66,66,0
246157,1393,306,66,77,11
242317,1817,398,66,75,9
252324,1668,358,66,80,14
255908,1437,315,66,77,11
245632,965,350,66,80,14
259707,1650,362,66,66,0
239023,1856,392,66,75,9
234671,1585,351,66,74,8
214447,1768,373,66,66,0
260270,1803,383,66,66,0
256942,1689,365,66,84,18
232110,975,348,66,74,8
230830,1544,319,66,66,0
212910,1644,360,66,66,0
210862,1417,301,66,67,1
208302,1907,404,66,69,3
259245,1688,359,66,66,0
214701,1602,342,66,75,9
211373,1560,334,66,66,0
202413,1791,376,66,66,0
251052,1708,360,66,68,2
199088,1805,393,66,66,0
207740,1611,348,66,68,2
226220,1775,375,66,69,3
230268,1590,323,66,66,0
221824,1854,391,66,66,0
237439,1695,363,66,66,0
236415,1468,318,66,67,1
206207,1667,356,66,67,1
192126,1760,379,66,66,0
257406,1663,354,66,77,11
225406,1151,366,66,73,7
210046,1781,375,66,66,0
253565,1533,340,66,66,0
239485,1558,336,66,70,4
223357,1769,373,66,71,5
213117,1710,369,66,66,0
201085,1769,368,66,66,0
261756,1733,369,66,76,10
232316,1614,344,66,73,7
247468,1693,368,66,73,7
214700,1607,344,66,67,1
208549,1747,374,66,66,0
245159,1520,321,66,71,5
231335,1602,344,66,67,1
203175,1130,366,66,68,2
255398,1525,329,66,80,14
248230,1712,378,66,73,7
209062,1754,372,66,66,0
262566,1458,310,66,76,10
262053,1567,342,66,87,21
193701,1752,369,66,66,0
258725,1714,366,66,75,9
257957,1510,338,66,72,6
256421,1707,370,66,69,3
239269,1669,361,66,73,7
229285,1796,391,66,71,5
223909,1016,363,66,72,6
221605,1525,342,66,67,1
242343,1468,315,66,74,8
246951,1694,370,66,72,6
247467,1466,320,66,80,14
188071,1701,355,66,66,0
232619,1762,363,66,66,0
260266,1495,315,66,66,0
193706,1559,331,66,66,0
243882,1717,385,66,71,5
242090,1617,362,66,74,8
192169,1719,355,66,66,0
246441,1763,385,66,66,0
211881,1741,363,66,66,0
208297,1882,414,66,69,3
205225,1576,339,66,66,0
189352,1707,363,66,66,0
248744,1675,359,66,71,5
236712,1578,349,66,72,6
220584,1153,372,66,72,6
204968,1680,365,66,67,1
238923,1760,385,66,66,0
189397,1616,332,66,66,0
226791,1613,353,66,73,7
227789,1663,364,66,66,0
205005,1724,367,66,66,0
260044,1467,321,66,80,14
253644,1534,337,66,66,0
248780,1562,355,66,66,0
244940,1643,370,66,71,5
230860,1883,402,66,73,7
224460,1505,332,66,71,5
262091,1695,354,66,77,11
251595,1752,379,66,73,7
183499,1364,291,66,66,0
215755,1631,357,66,66,0
262859,1633,353,66,83,17
192970,1829,386,66,66,0
243914,1757,378,66,69,3
238282,1866,401,66,77,11
213206,1122,375,66,66,0
216790,1844,390,66,68,2
228310,1644,363,66,70,4
238038,1725,372,66,76,10
202199,1105,366,66,69,3
264422,1586,338,66,83,17
208102,1456,313,66,67,1
212710,1061,370,66,72,6
232166,1782,378,66,66,0
235213,1167,361,66,69,3
216526,1653,346,66,66,0
227278,1670,356,66,71,5
251089,1868,396,66,66,0
229605,1768,377,66,71,5
239589,1589,348,66,73,7
248805,1575,331,66,80,14
193765,901,363,66,66,0
201940,1077,354,66,66,0
194003,1587,344,66,66,0
238803,1644,357,66,72,6
231123,1626,349,66,69,3
204499,1387,293,66,68,2
252114,1657,353,66,76,10
233170,1718,373,66,66,0
248017,1805,389,66,66,0
173518,1672,351,66,66,0
247249,1600,340,66,74,8
160209,1772,367,66,66,0
209361,1780,382,66,67,1
252368,1447,305,66,66,0
260815,1626,353,66,80,14
253903,1827,391,66,76,10
247503,1623,350,66,66,0
240847,1425,323,66,73,7
239567,1659,358,66,66,0
236751,1527,331,66,66,0
259790,1636,355,66,75,9
239078,1588,338,66,67,1
237031,1600,341,66,66,0
228325,1821,392,66,66,0
224488,1766,376,66,68,2
251373,1739,375,66,71,5
192237,1765,380,66,66,0
224238,1438,315,66,70,4
226542,1096,375,66,66,0
242670,1859,389,66,76,10
247278,1648,369,66,72,6
247534,1575,344,66,74,8
216815,1369,298,66,69,3
232687,1597,346,66,66,0
236271,1417,293,66,67,1
253167,1643,355,66,82,16
254447,1765,369,66,68,2
196848,1650,341,66,66,0
231408,1589,354,66,71,5
260080,1562,338,66,78,12
217841,1356,309,66,66,0
221425,1804,387,66,66,0
243953,1674,357,66,72,6
246001,1749,379,66,74,8
248049,1637,356,66,80,14
188145,1578,337,66,66,0
208370,1804,388,66,66,0
241394,1574,346,66,75,9
243442,1651,361,66,76,10
210134,1426,307,66,66,0
241645,1785,377,66,75,9
212973,1116,374,66,71,5
235244,1579,344,66,71,5
239337,1735,370,66,66,0
225768,1760,379,66,72,6
235496,1806,395,66,72,6
245736,1643,370,66,72,6
184040,1129,373,66,66,0
253416,1473,323,66,80,14
254184,1764,370,66,71,5
193768,1805,379,66,66,0
214761,1134,371,66,66,0
225769,1800,384,66,72,6
227561,1722,365,66,66,0
231145,1808,387,66,70,4
240873,1717,362,66,76,10
220396,1629,343,66,66,0
260841,1357,295,66,68,2
261097,1614,350,66,73,7
261865,1539,339,66,81,15
203754,1745,364,66,66,0
229354,1728,359,66,72,6
229610,1650,361,66,71,5
232426,1672,347,66,67,1
245226,1411,307,66,77,11
264427,1571,340,66,76,10
205291,1849,384,66,69,3
241131,1734,369,66,66,0
229349,1560,338,66,72,6
240333,1455,315,66,70,4
251364,1447,315,66,69,3
241652,1716,378,66,66,0
235769,1620,354,66,72,6
148729,1189,353,66,66,0
200697,1430,309,66,66,0
259576,1599,344,66,78,12
183544,1650,346,66,66,0
204536,1019,352,66,66,0
252407,1414,305,66,76,10
202231,1868,385,66,66,0
198135,1678,371,66,66,0
238820,1784,395,66,71,5
258037,1678,358,66,81,15
227573,1560,341,66,67,1
263669,1569,342,66,77,11
236020,1589,342,66,73,7
216791,1571,339,66,68,2
223732,1191,374,66,66,0
221684,1766,373,66,66,0
229107,1619,360,66,72,6
204787,1785,366,66,67,1
260082,1657,355,66,79,13
189938,1741,356,66,66,0
179698,1795,378,66,66,0
244948,1681,361,66,72,6
243156,1713,371,66,79,13
236244,1551,347,66,74,8
226004,1580,337,66,68,2
202708,1740,367,66,66,0
205015,1737,376,66,66,0
254201,1710,374,66,71,5
207610,1087,372,66,66,0
222970,1764,348,66,66,0
223738,1120,363,66,70,4
245461,1623,334,66,75,9
244949,1544,345,66,69,3
229845,1796,375,66,66,0
224981,1582,347,66,68,2
223957,1043,356,66,69,3
206549,1174,358,66,66,0
255700,1610,349,66,78,12
248575,1512,331,66,75,9
235263,1436,313,66,69,3
233727,1672,371,66,76,10
254206,1703,362,66,75,9
208894,1155,368,66,66,0
235261,1414,305,66,71,5
233981,1759,374,66,66,0
262140,1438,309,66,76,10
235516,1719,376,66,70,4
234492,1262,353,66,66,0
233212,1468,311,66,71,5
239611,1604,349,66,67,1
237563,1597,361,66,73,7
236283,1719,369,66,72,6
235771,1764,373,66,73,7
232955,1829,386,66,70,4
229883,1643,358,66,67,1
255994,996,364,66,70,4
230906,1853,395,66,67,1
224250,1579,341,66,67,1
213719,1153,368,66,66,0
193013,988,348,66,66,0
247009,1658,368,66,67,1
222431,1087,358,66,72,6
242907,1648,361,66,76,10
251611,1756,385,66,67,1
253915,1625,331,66,71,5
230876,1775,388,66,71,5
232668,1437,306,66,73,7
251868,1664,361,66,75,9
256476,1519,342,66,81,15
193244,1178,367,66,66,0
232669,1789,378,66,75,9
255965,958,353,66,74,8
228318,1681,354,66,73,7
246750,1673,358,66,70,4
205535,1845,394,66,66,0
238303,1663,365,66,75,9
239835,1641,372,66,71,5
250847,1417,320,66,73,7
216288,1752,379,66,67,1
224225,1794,385,66,72,6
226785,1666,355,66,67,1
240097,1786,384,66,74,8
194785,1528,331,66,66,0
233442,1794,396,66,77,11
237538,1836,394,66,66,0
251362,1693,367,66,66,0
206563,1839,379,66,66,0
231139,1585,342,66,73,7
186595,1775,382,66,66,0
235236,1725,377,66,66,0
242651,1775,379,66,66,0
176348,1769,351,66,66,0
223963,1567,334,66,74,8
243929,1365,294,66,66,0
206555,1136,377,66,71,5
236247,1777,373,66,74,8
186839,1751,364,66,66,0
253399,1821,395,66,73,7
193495,1825,371,66,66,0
234200,1769,372,66,70,4
206297,1643,353,66,66,0
235225,1766,378,66,66,0
189143,1727,365,66,66,0
183513,1114,366,66,66,0
200667,1887,393,66,66,0
173530,1719,357,66,66,0
245722,1578,341,66,74,8
256730,1516,343,66,66,0
226266,1739,369,66,71,5
209317,1684,354,65,65,0
220581,1577,339,65,68,3
258466,1088,376,65,79,14
244133,1648,358,65,69,4
252325,1696,364,65,78,13
253093,1636,367,65,65,0
213670,1710,373,65,67,2
192165,1702,359,65,65,0
232614,1509,326,65,65,0
169638,1820,365,65,65,0
251558,1611,348,65,72,7
255140,1724,362,65,79,14
243622,1414,314,65,65,0
257188,1752,387,65,78,13
254372,1761,371,65,66,1
216227,1574,351,65,66,1
223907,1693,380,65,67,2
230819,1561,338,65,71,6
239523,1319,288,65,68,3
246691,1503,304,65,65,0
190883,1758,366,65,65,0
202916,1737,358,65,68,3
204196,1609,349,65,65,0
224420,1742,378,65,65,0
237988,1689,372,65,71,6
243364,1681,355,65,65,0
193958,1799,378,65,65,0
253348,1598,351,65,72,7
252326,1768,380,65,79,14
201132,1580,329,65,66,1
162471,1762,362,65,65,0
260267,1772,376,65,65,0
191915,1483,336,65,65,0
225708,1630,332,65,65,0
240812,1797,385,65,72,7
242092,1683,368,65,66,1
201901,1850,396,65,65,0
216237,1790,370,65,65,0
216493,1551,336,65,65,0
163757,1614,350,65,65,0
231597,1729,370,65,70,5
234669,953,348,65,73,8
251565,1768,375,65,77,12
186541,1632,332,65,65,0
243041,1641,350,65,76,11
209323,1595,338,65,65,0
226216,1727,367,65,66,1
237226,1628,363,65,67,2
232874,1689,357,65,65,0
222378,1519,333,65,68,3
222122,1628,359,65,65,0
204458,1524,349,65,66,1
191657,1736,363,65,65,0
252073,1518,338,65,77,12
247721,1734,371,65,75,10
232617,1771,375,65,65,0
140201,1614,317,65,65,0
247976,1048,357,65,71,6
242856,1581,333,65,79,14
232872,1456,325,65,70,5
256097,1482,327,65,78,13
233047,1577,349,65,74,9
198241,1668,360,65,65,0
260184,1730,361,65,74,9
236890,1645,352,65,75,10
231514,1730,364,65,65,0
231258,954,346,65,73,8
198490,1842,377,65,65,0
193113,1810,384,65,65,0
256345,1596,344,65,75,10
237913,1571,338,65,66,1
225625,1748,383,65,70,5
202841,1656,355,65,65,0
202073,1653,352,65,65,0
196953,1583,352,65,66,1
261208,1725,355,65,65,0
260952,1649,340,65,84,19
240728,1544,344,65,71,6
250976,1564,340,65,74,9
167512,1778,383,65,65,0
253527,1712,359,65,65,0
251223,1551,329,65,80,15
223537,1555,312,65,65,0
203095,1707,374,65,65,0
263255,1561,343,65,72,7
257878,1655,358,65,79,14
255830,1771,374,65,70,5
232790,991,341,65,65,0
264022,1616,348,65,82,17
257431,1642,339,65,70,5
53655,1527,308,65,65,0
232343,1705,359,65,65,0
238938,1490,313,65,65,0
239706,1786,378,65,68,3
116314,1152,361,65,65,0
210011,1752,374,65,65,0
247904,1541,331,65,65,0
246112,1590,350,65,78,13
242528,1608,341,65,74,9
224864,1757,371,65,65,0
224608,1682,360,65,65,0
208992,1665,362,65,65,0
243807,1816,386,65,67,2
224095,1808,384,65,68,3
221279,1826,363,65,68,3
255838,1646,362,65,74,9
252254,1693,359,65,71,6
251486,1808,391,65,68,3
234846,895,342,65,71,6
199774,1700,353,65,65,0
263518,1555,337,65,75,10
236637,1770,389,65,74,9
214365,1421,312,65,65,0
202589,1734,378,65,65,0
263005,1672,356,65,71,6
260188,1840,391,65,72,7
259164,1690,369,65,72,7
253276,1625,349,65,67,2
232540,1765,379,65,65,0
190555,1744,364,65,65,0
186715,1746,376,65,65,0
240987,974,347,65,76,11
222299,1618,353,65,65,0
219566,1577,348,65,67,2
192328,1708,361,65,65,0
247601,1516,340,65,81,16
237116,1422,312,65,72,7
211096,1671,365,65,65,0
216472,1650,350,65,66,1
264424,912,354,65,67,2
262376,1682,370,65,67,2
254951,1688,360,65,77,12
253927,1736,366,65,66,1
183527,1805,363,65,65,0
243431,1286,281,65,75,10
242919,1513,330,65,76,11
237799,1615,353,65,65,0
225511,1207,366,65,70,5
224487,1774,369,65,67,2
258534,1095,362,65,77,12
247014,1520,344,65,77,12
234726,1652,364,65,74,9
222438,1112,363,65,65,0
221926,1701,355,65,66,1
208614,1591,332,65,66,1
201958,1549,340,65,66,1
244028,1507,345,65,74,9
204860,1589,344,65,65,0
181989,1782,367,65,65,0
194363,1870,395,65,65,0
255798,1479,331,65,68,3
195126,1733,363,65,65,0
263991,1558,331,65,71,6
201527,1586,356,65,65,0
222519,1890,400,65,65,0
224311,1767,384,65,66,1
230455,1574,331,65,65,0
215864,1653,364,65,68,3
228408,1772,365,65,74,9
234296,1616,348,65,73,8
237368,1512,318,65,71,6
239928,1483,332,65,68,3
244024,1620,344,65,80,15
233017,1652,350,65,70,5
244537,1536,331,65,71,6
188985,1821,383,65,65,0
230458,1664,345,65,65,0
244538,1453,310,65,66,1
237371,1615,354,65,72,7
260325,1530,325,65,65,0
206565,1785,378,65,65,0
243254,1686,370,65,74,9
223968,1086,368,65,65,0
198624,1520,334,65,65,0
262880,1746,384,65,81,16
258783,1674,359,65,72,7
253407,1648,347,65,82,17
247519,1648,357,65,80,15
244703,1618,338,65,65,0
242655,1705,362,65,75,10
237535,1665,357,65,72,7
237023,1628,351,65,65,0
223967,1642,352,65,74,9
211935,1684,361,65,65,0
257502,1745,383,65,72,7
224734,1561,332,65,68,3
262622,1480,316,65,68,3
177885,1745,366,65,65,0
226781,1637,366,65,65,0
186882,1163,357,65,65,0
250882,1680,354,65,68,3
232194,1626,340,65,70,5
218848,1730,363,65,65,0
232928,1768,387,65,67,2
203237,1118,357,65,65,0
254176,1427,302,65,74,9
247268,1783,386,65,73,8
199908,1715,381,65,65,0
263396,1481,323,65,73,8
255971,1699,368,65,81,16
187363,1110,364,65,66,1
248035,1764,383,65,66,1
242915,1758,394,65,65,0
222691,1671,368,65,65,0
212451,1835,388,65,65,0
203491,1732,370,65,65,0
244194,1757,385,65,65,0
242914,1688,362,65,74,9
241890,1663,365,65,71,6
237794,1811,393,65,71,6
231650,1518,327,65,76,11
227810,1784,375,65,65,0
253409,1514,335,65,73,8
240865,1673,357,65,73,8
259296,902,342,65,72,7
251446,1526,330,65,72,7
241206,929,341,65,68,3
229073,1712,374,65,68,3
216269,1732,364,65,65,0
257484,1765,369,65,75,10
257228,1687,370,65,70,5
232908,1797,378,65,65,0
262348,1742,374,65,65,0
257483,1745,378,65,74,9
256459,1469,320,65,77,12
240331,1795,400,65,71,6
160203,1518,325,65,65,0
203210,1674,356,65,65,0
262858,1620,341,65,76,11
253129,1803,379,65,72,7
240585,1632,355,65,74,9
238793,1712,376,65,69,4
229065,1402,303,65,67,2
255432,1588,346,65,77,12
251336,1487,339,65,71,6
220872,1651,360,65,70,5
260295,1468,333,65,72,7
194759,1482,323,65,65,0
260812,1475,315,65,67,2
224973,1710,367,65,68,3
215495,1710,365,65,68,3
231885,1793,382,65,65,0
263633,1586,338,65,72,7
261072,1661,345,65,79,14
258768,1554,339,65,77,12
242640,1686,362,65,75,10
211152,1732,373,65,66,1
189391,1392,297,65,65,0
253135,1766,379,65,73,8
230607,1775,384,65,65,0
160207,1780,368,65,65,0
206031,1603,340,65,65,0
258510,1652,367,65,74,9
253902,1776,380,65,72,7
247758,1752,377,65,76,11
236750,1621,372,65,68,3
230094,1677,351,65,65,0
226510,1728,371,65,72,7
225998,1839,391,65,68,3
198094,1809,377,65,65,0
232397,1702,362,65,65,0
248007,1555,349,65,65,0
262343,1630,359,65,65,0
238902,1409,298,65,65,0
256307,1641,345,65,83,18
235572,1435,312,65,72,7
243252,1639,358,65,74,9
244020,1148,356,65,71,6
246324,1799,385,65,65,0
257332,1632,356,65,70,5
261172,1750,377,65,74,9
199477,1698,366,65,65,0
207925,1676,359,65,65,0
217653,1624,337,65,65,0
234293,1801,376,65,65,0
239925,1606,345,65,71,6
241973,1653,366,65,71,6
251189,1623,365,65,72,7
189237,1802,384,65,65,0
210742,1862,388,65,67,2
146486,993,341,65,65,0
227894,1737,370,65,65,0
231222,1764,379,65,68,3
234294,1770,366,65,74,9
219700,1747,371,65,66,1
254003,1433,301,65,74,9
255686,1542,343,65,70,5
235059,1652,351,65,75,10
252870,1656,353,65,79,14
252358,1785,379,65,65,0
251846,1754,373,65,69,4
243398,1602,361,65,65,0
155334,1570,326,65,65,0
263366,1521,328,65,74,9
244421,1141,364,65,71,6
231109,1699,361,65,72,7
220357,1717,352,65,65,0
195012,1622,345,65,65,0
253892,1527,327,65,65,0
251076,1788,387,65,72,7
210482,1576,338,65,65,0
234290,1350,301,65,74,9
246834,1678,349,65,68,3
260658,1572,356,65,80,15
198195,1562,340,65,65,0
229171,1691,370,65,65,0
234291,1510,339,65,74,9
244277,1639,355,65,76,11
228751,1778,382,65,72,7
231575,1592,337,65,68,3
220650,1635,367,65,66,1
245566,1562,337,65,75,10
240446,1393,310,65,65,0
225342,1095,362,65,71,6
210494,1691,363,65,66,1
257341,1605,351,65,70,5
243773,1709,362,65,74,9
255036,1632,356,65,79,14
254268,1621,350,65,75,10
244284,1504,335,65,71,6
230888,1797,388,65,72,7
232424,1456,308,65,70,5
170472,1745,375,65,65,0
248040,1677,364,65,72,7
251880,1539,346,65,80,15
253928,1647,344,65,70,5
258536,1829,395,65,80,15
219625,1547,341,65,68,3
244201,1687,359,65,76,11
187113,1795,363,65,65,0
251198,1623,347,65,78,13
204095,1763,381,65,65,0
225087,1634,359,65,70,5
260417,1459,315,65,71,6
259139,1540,328,65,79,14
254019,1595,352,65,77,12
243523,1457,301,65,65,0
240451,1701,368,65,74,9
173891,1855,399,65,65,0
209475,1709,378,65,65,0
203331,1627,350,65,65,0
195905,1549,332,65,65,0
259905,1613,359,65,74,9
242751,1427,314,65,73,8
254273,1714,374,65,80,15
244801,1501,324,65,65,0
243009,1444,313,65,71,6
251456,1434,319,65,73,8
240448,1683,366,65,77,12
234816,1670,354,65,65,0
200256,1826,373,65,65,0
259903,1543,332,65,75,10
258025,1671,356,65,65,0
231402,1835,382,65,72,7
242500,1504,326,65,65,0
236010,1746,376,65,74,9
236270,1751,378,65,66,1
236782,1563,337,65,73,8
252910,1572,344,65,79,14
258286,1519,333,65,71,6
259054,1660,342,65,81,16
225519,1565,343,65,70,5
236783,1572,335,65,74,9
255471,1752,376,65,70,5
257007,1547,338,65,79,14
262384,1736,370,65,69,4
211952,1665,361,65,65,0
221680,1518,317,65,65,0
176368,1784,377,65,65,0
189936,1140,360,65,65,0
203249,1711,362,65,65,0
204785,1694,364,65,67,2
211953,1037,358,65,65,0
237809,1582,337,65,71,6
251633,1624,358,65,78,13
208878,1758,375,65,65,0
245997,1643,354,65,74,9
215277,1515,327,65,66,1
241643,919,360,65,74,9
248810,1530,331,65,69,4
254954,1460,315,65,65,0
255210,1732,375,65,75,10
259818,1528,337,65,74,9
211435,1456,313,65,66,1
212971,1723,363,65,65,0
219627,1687,375,65,71,6
240363,1648,358,65,66,1
246763,1647,352,65,80,15
193260,1512,330,65,65,0
53739,1237,367,65,65,0
254443,1743,378,65,65,0
189163,1893,400,65,65,0
154860,1782,372,65,65,0
220908,1730,374,65,68,3
243180,1684,365,65,74,9
244460,1582,340,65,70,5
254444,1745,389,65,65,0
226628,1348,290,65,65,0
263493,1577,336,65,69,4
208626,1650,362,65,65,0
235014,1653,353,65,71,6
255241,1521,334,65,76,11
251913,1665,366,65,72,7
184585,1096,376,65,65,0
181001,1088,376,65,65,0
244489,1697,370,65,70,5
243721,1642,355,65,72,7
238345,1657,372,65,72,7
264457,1470,325,65,68,3
196873,1727,366,65,65,0
259848,1680,357,65,80,15
258824,1744,375,65,75,10
203528,1653,362,65,65,0
263432,1561,340,65,66,1
251399,1589,340,65,66,1
248071,1045,341,65,65,0
244743,1834,389,65,72,7
237575,940,342,65,78,13
236551,1565,345,65,74,9
233735,1607,353,65,70,5
263434,1441,310,65,74,9
217098,1598,351,65,65,0
235018,1000,344,65,71,6
239627,1638,344,65,66,1
231241,1739,370,65,74,9
254732,1525,332,65,66,1
248588,1759,382,65,77,12
231948,1665,358,65,67,2
221964,1093,361,65,66,1
215820,1862,387,65,68,3
263180,1478,320,65,71,6
244235,1641,360,65,74,9
233227,1569,343,65,68,3
243210,1628,358,65,69,4
232203,1803,402,65,72,7
231947,1550,330,65,74,9
223755,1670,346,65,67,2
156683,1848,385,65,65,0
259850,1735,372,65,67,2
255754,950,346,65,70,5
254986,1565,333,65,71,6
245770,1604,345,65,74,9
225799,1728,371,65,68,3
232966,1668,341,65,65,0
208965,1488,317,65,65,0
224518,1663,357,65,66,1
255047,1394,302,65,71,6
252999,1642,355,65,79,14
241479,1491,326,65,76,11
238919,948,349,65,71,6
236615,1758,368,65,74,9
232519,1591,354,65,76,11
230471,1719,356,65,65,0
229703,1515,328,65,68,3
209223,1733,372,65,65,0
256326,1619,347,65,82,17
235590,1183,367,65,70,5
232518,966,353,65,71,6
230214,1552,314,65,65,0
212806,1648,370,65,65,0
199750,1753,373,65,65,0
246341,1790,373,65,65,0
245061,1772,384,65,74,9
175941,1455,313,65,65,0
220997,1603,350,65,65,0
204104,1534,323,65,65,0
208968,1115,363,65,66,1
221768,1612,351,65,65,0
210437,1727,362,65,69,4
217606,1720,380,65,65,0
210182,1523,328,65,65,0
261637,1738,378,65,75,10
241157,1663,361,65,73,8
239365,1683,365,65,69,4
234501,1691,378,65,74,9
228869,1694,364,65,72,7
217093,1664,357,65,65,0
254212,1678,358,65,74,9
222024,911,343,65,67,2
162052,1108,357,65,65,0
263172,1811,392,65,65,0
258819,1612,349,65,78,13
243459,1664,357,65,68,3
235267,1441,323,65,73,8
210691,1702,381,65,66,1
232520,1663,365,65,72,7
229704,1031,363,65,68,3
258289,1702,373,65,82,17
225266,1837,384,65,72,7
221847,1893,394,65,65,0
200845,1708,354,65,65,0
252807,1641,354,65,66,1
242568,1808,379,65,72,7
243080,1432,321,65,74,9
199049,1542,323,65,65,0
211594,1630,364,65,67,2
211850,1757,375,65,65,0
221322,1579,344,65,70,5
241034,1658,361,65,73,8
214923,1806,391,65,67,2
219275,1701,363,65,65,0
229259,1513,329,65,65,0
231307,1718,382,65,70,5
232843,1728,370,65,71,6
200844,1676,367,65,65,0
232076,1764,376,65,65,0
234636,1583,345,65,65,0
237964,1765,381,65,65,0
186508,1059,343,65,66,1
254604,982,345,65,67,2
246407,1488,323,65,66,1
224391,1472,313,65,65,0
205447,1807,383,65,65,0
190852,1633,349,65,65,0
204931,1219,382,65,68,3
229507,1350,285,65,65,0
184707,1606,336,65,65,0
215684,1829,388,65,65,0
229508,1732,377,65,67,2
234372,1677,363,65,65,0
239492,1762,378,65,66,1
241540,1747,382,65,71,6
257924,1630,359,65,65,0
187782,1690,344,65,65,0
258692,1626,355,65,70,5
235141,920,343,65,71,6
140422,1509,321,65,65,0
215430,1773,381,65,66,1
215686,1601,335,65,65,0
226438,1626,348,65,69,4
228230,1751,372,65,65,0
231814,1601,344,65,65,0
189836,1804,373,65,65,0
202125,1142,372,65,67,2
257154,1586,347,65,73,8
209805,1080,358,65,65,0
222611,1774,369,65,70,5
241044,1457,308,65,73,8
242068,904,345,65,74,9
253844,1087,354,65,67,2
223125,1745,382,65,65,0
225685,1733,380,65,68,3
228757,1619,350,65,69,4
245653,1519,331,65,70,5
248213,1453,309,65,74,9
193173,1858,396,65,65,0
199830,1758,373,65,65,0
221846,1703,374,65,65,0
222870,1798,385,65,70,5
223638,1488,326,65,69,4
233878,1807,381,65,67,2
234902,1707,379,65,72,7
237718,1633,360,65,71,6
253846,1017,356,65,65,0
258710,1566,349,65,76,11
216467,1734,353,65,66,1
264595,1622,342,65,74,9
253842,1084,367,65,67,2
246158,1088,364,65,75,10
214413,1732,374,65,65,0
215693,1200,363,65,65,0
262286,899,353,65,65,0
199566,1797,375,65,65,0
207502,1674,360,65,65,0
213646,1031,351,65,68,3
234382,1709,363,65,69,4
236174,1585,341,65,65,0
251790,1675,353,65,74,9
244626,1498,326,65,75,10
224770,1652,356,65,68,3
246415,1698,377,65,76,11
240528,1747,374,65,72,7
241040,1567,346,65,73,8
256912,1542,337,65,78,13
251281,1745,375,65,69,4
205202,1602,326,65,65,0
244114,1566,349,65,77,12
202115,1769,366,65,65,0
235906,1663,367,65,74,9
243698,1403,302,65,73,8
241659,1619,359,65,72,7
216823,1519,321,65,66,1
229367,1702,364,65,71,6
236279,1557,337,65,70,5
173815,1573,330,65,65,0
240119,1596,352,65,71,6
254711,1643,353,65,65,0
248056,1663,365,65,65,0
258040,1793,388,65,68,3
232697,1553,342,65,65,0
236281,1686,362,65,66,1
238329,1715,379,65,71,6
239353,1623,356,65,72,7
246265,1637,354,65,65,0
190457,1794,387,65,65,0
260089,1492,312,65,70,5
208122,1647,357,65,65,0
192250,1499,325,65,65,0
260090,1673,360,65,65,0
262138,1568,338,65,80,15
260086,1586,336,65,75,10
256502,1597,346,65,78,13
243702,1524,345,65,79,14
215028,1815,382,65,65,0
255218,1555,341,65,79,14
259570,1547,342,65,84,19
241139,1421,319,65,68,3
251635,1752,367,65,65,0
254707,1609,350,65,65,0
196339,1743,370,65,65,0
205044,1712,350,65,65,0
212980,1436,310,65,65,0
215540,1760,389,65,65,0
239606,1757,378,65,69,4
229620,1742,374,65,65,0
178421,1701,358,65,65,0
246005,1561,348,65,77,12
248821,1698,374,65,72,7
188917,1741,375,65,65,0
204278,1732,369,65,65,0
210422,1099,363,65,65,0
229878,1695,362,65,71,6
225531,1733,358,65,70,5
243963,1859,399,65,71,6
203138,1845,379,65,65,0
259067,1003,353,65,72,7
253053,1715,370,65,72,7
258173,1613,349,65,65,0
203902,1773,361,65,65,0
231550,1690,383,65,65,0
246910,1594,344,65,78,13
252030,1613,340,65,73,8
237695,1004,348,65,70,5
239999,970,342,65,69,4
240511,1730,367,65,72,7
252799,888,345,65,71,6
263808,1611,352,65,65,0
220544,1521,335,65,65,0
223104,1748,360,65,65,0
253568,1549,334,65,75,10
213377,1539,328,65,65,0
213889,1768,380,65,68,3
220545,1674,358,65,65,0
244097,1591,362,65,71,6
261249,1700,358,65,82,17
246909,1746,373,65,74,9
211581,1668,363,65,67,2
244348,1608,343,65,70,5
223997,1732,372,65,65,0
221692,1658,357,65,70,5
225532,1695,361,65,70,5
226044,1632,335,65,66,1
236028,1180,381,65,73,8
186876,1603,336,65,65,0
254204,1602,345,65,74,9
204541,1565,347,65,65,0
220669,1715,366,65,70,5
264446,1500,335,65,69,4
239740,1581,332,65,72,7
222206,1675,354,65,66,1
231678,1411,326,65,69,4
237310,1814,385,65,70,5
242686,1672,355,65,69,4
245758,1629,348,65,75,10
226815,1690,361,65,65,0
239739,1645,358,65,71,6
263804,1540,345,65,75,10
229378,1749,366,65,74,9
244676,978,343,65,78,13
252929,1558,332,65,78,13
210715,1227,375,65,68,3
227866,1725,361,65,65,0
216346,1687,379,65,66,1
213274,1180,359,65,65,0
190489,1694,375,65,65,0
234521,1763,376,65,72,7
209177,1828,384,65,65,0
204825,1085,367,65,66,1
203569,1662,359,65,65,0
248112,1852,394,65,67,2
231728,1753,363,65,65,0
156464,1375,293,65,65,0
203824,1147,366,65,67,2
258095,1697,372,65,82,17
234799,1664,360,65,72,7
224558,1580,341,65,65,0
219694,1409,303,65,67,2
213294,1661,352,65,65,0
199470,1669,356,65,65,0
196910,1559,328,65,65,0
241946,1508,325,65,74,9
220187,1734,359,65,69,4
240941,1592,349,65,75,10
236315,1605,353,65,74,9
246047,1657,358,65,82,17
236831,1511,336,65,68,3
235807,1821,386,65,74,9
231455,1659,360,65,73,8
231199,1665,374,65,71,6
220191,1468,325,65,68,3
247582,1781,381,65,74,9
168990,1709,344,65,65,0
224542,1672,354,65,65,0
224286,1711,368,65,65,0
202014,1475,314,65,65,0
248861,1568,341,65,65,0
247069,1479,309,65,65,0
244509,1666,357,65,73,8
191260,1649,361,65,65,0
241436,1605,358,65,79,14
203292,1624,353,65,65,0
262428,1567,341,65,73,8
238363,1763,385,65,67,2
258093,1752,386,65,79,14
204333,1556,326,65,65,0
246190,1649,353,65,77,12
244521,1764,377,65,65,0
235049,1651,359,65,70,5
234281,1722,358,65,65,0
213801,1754,367,65,68,3
261160,1532,325,65,65,0
231720,911,355,65,70,5
229416,1687,362,65,65,0
198952,1793,380,65,65,0
257319,1525,334,65,79,14
190247,1730,358,65,65,0
255015,1619,345,65,77,12
235303,1506,340,65,70,5
206631,1834,376,65,65,0
262439,916,350,65,71,6
253990,998,349,65,72,7
251686,1564,341,65,76,11
184614,1530,314,65,65,0
241190,1526,323,65,72,7
233254,1706,350,65,65,0
228646,1585,351,65,73,8
243241,1605,339,65,76,11
255273,1458,323,65,74,9
258092,1678,363,65,80,15
259881,1558,342,65,66,1
191532,1475,316,65,65,0
183596,1081,360,65,65,0
235820,964,354,65,69,4
232748,1602,340,65,65,0
224556,1624,341,65,65,0
219948,1686,358,65,68,3
212481,1759,370,65,66,1
258603,1611,348,65,66,1
257579,1708,369,65,74,9
245035,1726,366,65,78,13
237867,1619,353,65,71,6
211499,1669,359,65,65,0
262699,1740,372,65,69,4
262443,1802,385,65,77,12
237098,1704,368,65,69,4
233514,1588,345,65,72,7
229930,1691,377,65,69,4
262442,1625,361,65,75,10
261161,1557,321,65,70,5
247071,1787,373,65,65,0
248351,1628,353,65,73,8
253983,1481,331,65,77,12
213368,1535,334,65,66,1
254327,1649,367,65,76,11
226679,1771,376,65,66,1
247414,1746,386,65,65,0
176246,1719,369,65,65,0
234358,1640,368,65,69,4
191861,1646,342,65,65,0
241269,1765,385,65,71,6
255860,1587,334,65,77,12
245364,1629,347,65,74,9
243572,1431,314,65,72,7
240500,1538,341,65,71,6
232308,1717,371,65,65,0
221812,1716,362,65,65,0
263028,1579,358,65,82,17
256883,1623,351,65,80,15
247411,939,335,65,79,14
238963,1365,295,65,71,6
227443,1746,347,65,65,0
224115,1737,375,65,66,1
254583,1557,338,65,72,7
259704,1525,320,65,65,0
234784,1738,369,65,66,1
208505,1753,376,65,65,0
221358,1693,358,65,71,6
236923,1670,361,65,72,7
236667,1532,335,65,66,1
221819,1804,380,65,65,0
211067,1443,323,65,68,3
198011,1572,340,65,65,0
262267,1525,342,65,73,8
251770,1651,362,65,79,14
170362,1730,368,65,65,0
229498,1679,364,65,72,7
213626,1088,369,65,65,0
210042,1884,393,65,65,0
206202,1897,403,65,65,0
263290,1590,346,65,72,7
263034,1588,353,65,70,5
178297,1811,378,65,65,0
229753,1768,380,65,73,8
227961,1603,352,65,69,4
224633,1594,345,65,67,2
205939,1823,384,65,66,1
251762,1556,337,65,74,9
248434,1643,353,65,67,2
238450,1394,306,65,67,2
248099,1794,378,65,65,0
246563,1501,325,65,73,8
237347,1694,361,65,71,6
160035,1682,356,65,65,0
203043,1654,365,65,65,0
242722,1397,297,65,72,7
229154,1631,347,65,65,0
214818,1590,340,65,65,0
256545,1789,377,65,66,1
248097,1692,369,65,65,0
231713,1623,349,65,70,5
229409,1654,351,65,65,0
221985,1254,278,65,66,1
213281,1691,362,65,65,0
212513,1596,351,65,68,3
203809,1562,346,65,65,0
261152,996,348,65,65,0
253472,1664,362,65,78,13
252192,1508,326,65,80,15
193059,1701,349,65,65,0
219684,1729,381,65,65,0
160292,1746,347,65,65,0
224624,1624,351,65,65,0
218738,1741,370,65,65,0
212338,1745,376,65,65,0
257649,1398,321,65,76,11
253809,1406,297,65,72,7
237169,1760,383,65,68,3
235633,1054,368,65,77,12
262513,1515,320,65,84,19
242800,1650,359,65,75,10
252527,1539,332,65,80,15
252964,1558,336,65,77,12
241007,1578,349,65,74,9
230511,1575,353,65,65,0
223855,1849,387,65,65,0
263791,1528,323,65,75,10
255854,1379,290,65,81,16
255781,1539,346,65,76,11
232741,1669,347,65,65,0
255524,1388,296,65,74,9
157734,1170,374,65,65,0
223014,1758,367,65,66,1
219661,1724,368,65,68,3
257303,1521,335,65,73,8
237592,1692,365,65,66,1
247320,1654,364,65,72,7
253464,1628,355,65,71,6
192792,1089,358,65,65,0
254719,1479,325,65,72,7
228863,1708,356,65,69,4
257621,1648,357,65,69,4
236629,1728,374,65,70,5
240212,937,368,65,68,3
235860,1003,354,65,75,10
234836,1754,367,65,70,5
199508,1629,342,65,65,0
198740,1828,363,65,65,0
197716,1778,383,65,65,0
196948,1847,383,65,65,0
248147,1679,360,65,77,12
236627,1703,360,65,73,8
235347,1707,369,65,72,7
233043,1669,349,65,65,0
220184,1600,342,65,66,1
252183,1515,338,65,74,9
246547,1525,333,65,73,8
243735,990,353,65,70,5
254739,1533,331,65,66,1
221972,1628,334,65,66,1
230676,1563,342,65,72,7
165908,1798,378,65,65,0
237332,1786,383,65,65,0
239892,1598,339,65,74,9
246548,1666,354,65,80,15
261652,1578,346,65,76,11
262165,1651,350,65,69,4
202517,1614,332,65,65,0
239125,1550,333,65,75,10
244757,1563,339,65,77,12
181013,1738,342,65,65,0
247061,1680,368,65,65,0
251669,1758,376,65,72,7
254741,1530,331,65,65,0
228887,1381,308,65,65,0
237335,1580,345,65,73,8
237591,1513,344,65,66,1
225875,1878,393,65,65,0
253522,1503,335,65,69,4
247122,1478,324,65,80,15
214354,1778,373,65,65,0
253772,1808,377,65,68,3
243276,1656,354,65,72,7
231500,1696,358,65,66,1
247883,1517,334,65,65,0
172619,1626,337,65,65,0
236875,1642,368,65,74,9
225355,1706,364,65,70,5
219467,1675,358,65,67,2
188490,1803,375,65,65,0
252490,1721,356,65,71,6
244810,966,352,65,73,8
239690,1722,372,65,72,7
226122,1513,324,65,68,3
216394,1646,343,65,66,1
203850,1544,333,65,65,0
262474,1478,320,65,74,9
258889,1635,363,65,77,12
258121,1598,354,65,80,15
237385,1822,384,65,67,2
200781,1828,387,65,66,1
238925,1657,356,65,65,0
241485,1732,375,65,73,8
223823,1161,367,65,71,6
204626,1747,371,65,65,0
202322,1716,353,65,66,1
255313,1749,376,65,65,0
237393,1622,345,65,76,11
212817,1620,343,65,65,0
211793,1441,320,65,67,2
242512,1620,354,65,72,7
239952,1449,307,65,72,7
219471,1377,303,65,65,0
241741,1684,351,65,69,4
193358,1788,358,65,65,0
255310,1564,342,65,70,5
184142,1778,378,65,65,0
182094,1720,355,65,65,0
240974,1659,350,65,74,9
227150,1851,383,65,65,0
138830,1641,328,65,65,0
254029,1452,315,65,67,2
253715,1622,345,65,83,18
244755,1379,303,65,67,2
221709,1751,374,65,66,1
229849,1847,387,65,68,3
222937,1821,385,65,71,6
255448,1722,371,65,66,1
242648,1722,379,65,68,3
236248,1585,338,65,75,10
222168,1669,355,65,70,5
212440,1787,376,65,65,0
248023,1638,352,65,65,0
246231,1640,354,65,78,13
245719,1602,349,65,70,5
224983,1588,339,65,65,0
158167,1583,336,65,65,0
246230,1646,361,65,73,8
244438,1834,389,65,72,7
202966,1628,345,65,65,0
259797,1739,375,65,69,4
247509,1635,352,65,80,15
233173,1801,385,65,65,0
212693,1749,389,65,66,1
253396,1618,348,65,81,16
226265,1842,391,65,72,7
231897,1755,389,65,66,1
202259,1505,325,65,67,2
176345,1194,363,65,65,0
225757,1686,371,65,66,1
251356,1685,366,65,67,2
241884,1782,386,65,72,7
240860,1606,340,65,77,12
232412,1847,394,65,70,5
226524,1155,374,65,72,7
202204,1765,375,65,66,1
256731,1567,333,65,71,6
254427,1747,379,65,65,0
240603,1754,378,65,70,5
238043,1615,360,65,66,1
235995,1528,329,65,74,9
224475,1172,371,65,65,0
220635,1857,379,65,69,4
264667,1497,328,65,68,3
262619,1478,315,65,67,2
228058,1591,329,65,68,3
261081,1536,334,65,70,5
258777,1417,305,65,71,6
175316,1685,364,65,65,0
239316,1691,368,65,65,0
172756,1651,340,65,65,0
222420,1785,381,65,67,2
221711,1696,367,65,65,0
239119,1795,374,65,65,0
263952,1649,349,65,65,0
205072,1792,377,65,65,0
228624,1364,293,65,66,1
240912,1542,334,65,75,10
192528,1547,326,65,65,0
259088,1365,303,65,73,8
261648,1700,360,65,65,0
224017,1645,352,65,69,4
232465,1545,312,65,65,0
234513,1323,287,65,65,0
246289,1683,359,65,76,11
186385,1765,364,65,65,0
200210,1866,386,65,65,0
208914,1436,306,65,65,0
241938,1746,374,65,76,11
254994,1426,312,65,68,3
197907,1619,342,65,65,0
220943,1600,358,65,65,0
260622,1632,370,65,67,2
110606,1127,356,65,65,0
244946,1603,350,65,69,4
221652,1421,299,65,66,1
209364,1691,360,65,66,1
207828,1662,354,65,66,1
244435,1806,388,65,70,5
243155,1614,349,65,76,11
242643,1598,349,65,72,7
240595,924,333,65,74,9
258770,1626,349,65,78,13
221906,1443,311,65,68,3
229646,1559,341,65,65,0
221394,1665,355,65,68,3
259281,1921,404,65,65,0
244945,1442,313,65,72,7
232657,1443,304,65,65,0
250893,1800,384,65,70,5
262158,1452,323,65,70,5
222222,1761,382,65,66,1
228366,1539,331,65,67,2
244398,1605,357,65,70,5
207660,1785,379,65,65,0
242623,1558,329,65,74,9
245351,1762,381,65,72,7
258412,1411,308,65,72,7
253292,1585,328,65,75,10
237420,1680,352,65,72,7
209004,1551,326,65,65,0
258923,1503,333,65,81,16
228715,1685,348,65,68,3
253034,1572,348,65,80,15
239210,1601,336,65,69,4
223082,1094,364,65,67,2
200298,1589,322,65,65,0
251497,1755,384,65,76,11
245865,920,341,65,79,14
239721,1623,350,65,65,0
224361,1811,387,65,70,5
211817,1700,361,65,66,1
205929,1658,358,65,65,0
255592,1689,349,65,70,5
252008,1717,360,65,78,13
159080,1820,355,65,65,0
213864,1530,318,65,71,6
209256,1373,289,65,66,1
197480,1602,332,65,65,0
255591,1670,359,65,68,3
211053,1044,364,65,69,4
230509,1610,345,65,65,0
233581,1683,365,65,65,0
259584,1727,368,65,78,13
195480,1722,366,65,65,0
256408,1700,364,65,79,14
251032,1662,366,65,65,0
245400,1592,351,65,69,4
242840,1652,364,65,69,4
217088,1568,317,65,65,0
221696,1755,365,65,65,0
235520,1668,355,65,75,10
253952,1729,368,65,75,10
258560,1592,340,65,77,12
260282,1870,398,65,71,6
257645,1395,290,65,65,0
242362,1436,307,65,69,4
261561,1678,360,65,75,10
200449,1450,319,65,65,0
259769,904,344,65,65,0
244921,1488,319,65,76,11
237497,1628,355,65,70,5
220089,1595,342,65,65,0
229742,1711,374,65,73,8
225134,1233,379,65,73,8
262510,1762,365,65,82,17
247911,1651,356,65,68,3
242279,1640,353,65,75,10
232372,1726,384,65,65,0
242023,1524,333,65,70,5
240312,1497,333,65,69,4
262584,1656,355,65,76,11
192439,1813,382,65,65,0
244919,1368,290,65,76,11
238519,1795,390,65,69,4
238263,1359,293,65,72,7
234167,1563,334,65,71,6
233655,1700,358,65,72,7
229815,1453,314,65,66,1
206263,1649,351,65,65,0
201911,1706,365,65,65,0
198839,1668,352,65,65,0
198071,1649,357,65,65,0
193206,1798,378,65,65,0
254902,1765,363,65,66,1
215990,1461,299,65,65,0
210870,1816,388,65,67,2
248245,1698,373,65,70,5
229557,1650,362,65,68,3
208309,1724,366,65,66,1
251572,1615,346,65,71,6
179636,1864,391,65,65,0
242612,1610,347,65,76,11
254136,1644,348,65,76,11
257121,1721,371,65,76,11
259937,922,347,65,72,7
243044,1792,381,65,77,12
236903,1741,380,65,65,0
162407,1622,341,65,65,0
205159,1535,330,65,66,1
247910,1551,332,65,65,0
232550,1468,311,65,65,0
259941,1612,354,65,70,5
254565,1727,365,65,75,10
244837,1596,352,65,71,6
229733,1260,269,65,67,2
209253,1762,379,65,65,0
171364,1797,376,65,65,0
213090,1431,306,65,65,0
235108,1715,372,65,67,2
222820,1009,345,65,69,4
228707,1354,285,65,74,9
224611,1708,367,65,65,0
156259,1677,360,65,65,0
221539,1655,345,65,66,1
208739,1863,393,65,65,0
204131,1666,345,65,68,3
253538,1674,367,65,75,10
221538,1553,336,65,69,4
261016,1661,358,65,70,5
199321,1041,346,65,66,1
212377,1872,399,65,65,0
233369,1777,378,65,68,3
238784,1660,362,65,69,4
227520,1564,342,65,68,3
204992,1695,362,65,65,0
257727,1595,349,65,68,3
246434,1711,368,65,74,9
240319,1623,355,65,73,8
225983,1222,373,65,65,0
224447,1733,369,65,68,3
223679,1574,339,65,66,1
216255,1704,355,65,66,1
213695,1804,381,65,70,5
200895,1833,384,65,65,0
264639,1570,353,65,70,5
198335,1831,380,65,65,0
257470,1621,348,65,80,15
262334,1600,354,65,77,12
187069,1718,369,65,65,0
248765,1510,342,65,76,11
243133,1624,359,65,82,17
237757,1603,359,65,72,7
236989,1166,366,65,66,1
223933,1552,348,65,70,5
208573,1096,357,65,71,6
248000,917,351,65,67,2
254912,1540,336,65,76,11
221633,1685,371,65,70,5
231107,1504,336,65,71,6
258210,1459,318,65,76,11
254626,1514,321,65,65,0
253858,1594,345,65,65,0
253346,1640,360,65,65,0
253090,971,350,65,66,1
240068,1599,336,65,65,0
222660,1527,330,65,69,4
212932,1750,364,65,65,0
240067,1594,347,65,65,0
171971,1836,376,65,65,0
225731,1796,390,65,65,0
232897,1706,368,65,68,3
223427,1628,346,65,67,2
207811,1843,389,65,65,0
258498,1042,373,65,83,18
192450,1663,354,65,65,0
244162,1721,386,65,65,0
243650,1782,393,65,75,10
212418,1605,332,65,65,0
208834,1402,282,65,68,3
206274,1711,360,65,65,0
242369,1774,373,65,80,15
262333,1602,342,65,82,17
251068,1613,349,65,65,0
206524,1572,342,65,67,2
262042,1444,325,65,76,11
220573,1626,345,65,65,0
204701,1617,342,65,65,0
214940,1422,303,65,66,1
251291,1735,370,65,70,5
247963,1425,298,65,65,0
239259,1390,310,65,74,9
238235,1803,376,65,75,10
234651,1680,371,65,65,0
228763,1743,380,65,70,5
223899,1632,349,65,65,0
244634,1722,375,65,76,11
254877,1611,328,65,73,8
243354,1733,383,65,72,7
234650,1720,366,65,65,0
231322,1550,340,65,70,5
200346,1748,368,65,65,0
253593,1650,356,65,65,0
251289,1529,330,65,75,10
243353,1705,366,65,78,13
242841,1543,343,65,80,15
242073,945,344,65,81,16
238489,1139,369,65,68,3
252573,1600,349,65,76,11
208030,1730,368,65,65,0
252859,1734,387,65,76,11
257185,1611,355,65,75,10
248507,1551,341,65,77,12
245691,1723,365,65,74,9
232379,1661,328,65,65,0
204219,1425,308,65,65,0
263099,1630,365,65,73,8
233378,1754,369,65,71,6
230306,1527,321,65,65,0
212130,1422,307,65,65,0
211362,1676,348,65,70,5
260513,1757,379,65,65,0
251041,1616,348,65,65,0
219806,1487,325,65,65,0
237217,1748,376,65,65,0
233121,1693,370,65,69,4
156321,1557,324,65,65,0
255136,1435,320,65,69,4
253856,1798,383,65,65,0
192671,1713,347,65,65,0
254879,1782,376,65,68,3
246175,1576,353,65,74,9
262303,1687,347,65,66,1
222622,1706,363,65,65,0
241076,907,355,65,72,7
210792,1658,356,65,65,0
230836,1642,363,65,72,7
204210,1529,317,65,65,0
204468,1653,362,65,65,0
253614,1508,330,65,65,0
255406,1489,322,65,77,12
244655,1573,340,65,68,3
253615,1768,378,65,79,14
205232,1764,371,65,65,0
214192,1450,326,65,65,0
247216,1725,362,65,69,4
259504,1597,347,65,79,14
164529,1560,320,65,65,0
253105,1591,348,65,70,5
254897,1329,292,65,70,5
260273,1699,370,65,73,8
198322,1737,364,65,65,0
172208,1819,373,65,65,0
213170,1734,364,65,65,0
212915,1126,367,65,66,1
202164,1756,359,65,65,0
231090,1713,366,65,65,0
254899,1677,373,65,70,5
241587,1646,359,65,72,7
240563,1479,328,65,76,11
220851,1690,362,65,66,1
234163,1671,364,65,70,5
259762,1630,361,65,80,15
184242,1849,388,65,65,0
240050,1713,374,65,65,0
235442,1418,307,65,72,7
234418,1757,383,65,66,1
259206,988,358,64,74,10
245639,1534,331,64,74,10
213127,1607,348,64,69,5
231303,1383,308,64,65,1
234631,1635,354,64,67,3
237959,1717,370,64,65,1
244871,1557,339,64,72,8
247944,1037,345,64,64,0
257159,1665,355,64,73,9
208776,908,334,64,67,3
228744,1673,365,64,70,6
236168,1754,350,64,64,0
240008,1534,340,64,72,8
240776,1127,358,64,75,11
260744,1584,329,64,73,9
259205,1700,367,64,79,15
201094,1113,369,64,66,2
237443,963,340,64,64,0
257669,947,343,64,74,10
260227,1588,351,64,68,4
232067,1484,319,64,64,0
234883,1772,370,64,68,4
208009,1611,342,64,64,0
241027,1669,359,64,76,12
243587,978,335,64,72,8
244867,1047,339,64,75,11
204420,1709,369,64,64,0
253573,1707,375,64,64,0
233092,1733,369,64,74,10
257412,1628,362,64,71,7
216453,1689,366,64,67,3
216709,1380,285,64,64,0
232581,1458,328,64,66,2
235397,1719,373,64,67,3
261000,1728,364,64,68,4
233869,1519,321,64,64,0
223369,1582,344,64,65,1
240777,1508,312,64,77,13
220558,1731,357,64,64,0
238990,1546,324,64,73,9
245390,1586,337,64,73,9
245902,1618,341,64,80,16
251022,1645,366,64,72,8
251534,1488,318,64,75,11
193166,1529,318,64,64,0
259214,1786,383,64,64,0
263823,1733,374,64,82,18
226447,1351,293,64,64,0
253583,1343,289,64,64,0
182160,1767,387,64,64,0
261264,1613,347,64,76,12
201873,995,352,64,64,0
253841,1136,367,64,64,0
197774,1627,346,64,64,0
260237,1566,348,64,82,18
252045,1617,346,64,77,13
229771,1480,325,64,71,7
245129,1615,357,64,71,7
183945,1631,370,64,64,0
258953,1680,356,64,70,6
260233,1443,309,64,72,8
261257,1580,343,64,79,15
230794,1657,349,64,65,1
236939,1470,324,64,66,2
250765,1668,365,64,67,3
252555,1675,363,64,75,11
214924,1624,351,64,67,3
232332,1388,320,64,65,1
148365,1641,334,64,64,0
216461,1602,331,64,69,5
254594,1591,346,64,73,9
264323,1681,363,64,76,12
263553,1685,351,64,68,4
247938,1600,348,64,65,1
210147,1683,361,64,64,0
240611,1859,406,64,75,11
241379,1685,362,64,75,11
253923,1644,346,64,64,0
254179,1529,338,64,64,0
254691,1637,355,64,64,0
259043,1575,345,64,77,13
244196,1563,347,64,77,13
255716,1651,359,64,67,3
204773,1064,370,64,64,0
225509,1726,373,64,67,3
233445,1618,340,64,67,3
235237,1000,350,64,69,5
176357,1691,345,64,64,0
242405,1574,344,64,74,10
254181,1629,359,64,64,0
222435,1628,343,64,66,2
190178,1644,360,64,64,0
246402,1725,368,64,76,12
250850,1646,368,64,68,4
220127,1544,326,64,64,0
232415,1753,370,64,64,0
234207,1626,358,64,75,11
257759,1504,331,64,65,1
262624,928,340,64,67,3
241120,1438,316,64,74,10
243680,1569,339,64,69,5
244448,1560,335,64,74,10
220385,1503,313,64,67,3
223969,1721,368,64,68,4
232929,1648,351,64,64,0
206562,1735,373,64,67,3
209890,1439,311,64,65,1
228834,1693,365,64,71,7
242402,1655,364,64,66,2
230118,1667,364,64,65,1
241894,1398,309,64,71,7
243430,1253,264,64,77,13
250854,1698,371,64,76,12
246656,1701,385,64,72,8
263041,1724,367,64,76,12
186514,1611,334,64,64,0
222337,1500,326,64,64,0
240513,1773,382,64,72,8
243585,980,350,64,82,18
252801,1019,367,64,72,8
253313,1550,344,64,72,8
263042,1798,383,64,71,7
264322,1594,345,64,78,14
155266,1800,369,64,64,0
224130,1113,358,64,69,5
233602,1487,322,64,74,10
242562,1481,324,64,73,9
243842,1787,386,64,69,5
242155,1539,339,64,67,3
238059,1576,329,64,70,6
259306,1715,367,64,80,16
263144,1632,351,64,74,10
255462,1705,367,64,72,8
255718,1599,361,64,74,10
260582,1592,348,64,70,6
261350,1529,331,64,74,10
163303,1720,341,64,64,0
259559,1468,325,64,75,11
258280,1750,371,64,69,5
215786,1667,356,64,64,0
229865,1695,365,64,69,5
241129,1619,352,64,64,0
243177,1694,358,64,70,6
255977,1609,353,64,75,11
260329,1462,323,64,75,11
199146,1839,392,64,64,0
240530,1733,381,64,67,3
258966,1730,367,64,76,12
262803,1715,365,64,66,2
247736,944,348,64,78,14
254904,1737,364,64,64,0
255928,1757,385,64,78,14
206521,1544,332,64,64,0
166841,1730,363,64,64,0
239545,1558,341,64,68,4
253625,1762,371,64,64,0
256697,1685,368,64,74,10
191673,1775,356,64,64,0
260025,1593,358,64,65,1
262842,1720,367,64,83,19
204730,1783,373,64,64,0
242618,1758,373,64,64,0
248762,1478,322,64,65,1
212923,1587,353,64,65,1
216251,1547,331,64,65,1
186808,1705,362,64,64,0
243640,1760,372,64,81,17
189331,1629,344,64,64,0
173752,1680,356,64,64,0
193627,1670,347,64,64,0
233051,1730,378,64,71,7
226651,1694,356,64,64,0
226139,1656,355,64,66,2
263259,1623,360,64,70,6
245338,1649,346,64,77,13
216154,1436,309,64,65,1
206170,1459,316,64,66,2
240729,1724,374,64,69,5
257368,1553,336,64,82,18
253528,1644,352,64,64,0
241240,1536,315,64,69,5
254903,967,345,64,64,0
261047,1497,323,64,73,9
229816,1562,348,64,65,1
184763,1144,347,64,64,0
257723,1475,312,64,67,3
209852,1591,347,64,68,4
216508,1588,352,64,65,1
254143,1604,345,64,74,10
251072,1707,357,64,70,6
208577,1817,383,64,64,0
234177,1644,364,64,71,7
235457,1739,379,64,64,0
238273,1676,360,64,75,11
213954,1116,358,64,69,5
215234,1592,342,64,64,0
225730,1672,362,64,64,0
251842,1759,378,64,71,7
257218,1688,356,64,72,8
264387,1523,332,64,77,13
166851,1493,303,64,64,0
234947,1599,341,64,66,2
238936,1616,345,64,65,1
251071,1689,362,64,73,9
244415,1419,296,64,65,1
210367,1647,350,64,64,0
225213,1095,350,64,66,2
229052,1091,368,64,67,3
245692,1799,376,64,69,5
190140,1739,372,64,64,0
213181,1584,349,64,64,0
220605,1635,348,64,67,3
208999,1720,371,64,64,0
240317,1535,335,64,74,10
261566,1538,328,64,74,10
242365,1686,353,64,73,9
183997,1799,378,64,64,0
251581,1623,351,64,76,12
234942,1579,343,64,69,5
260286,1792,378,64,66,2
260542,1533,336,64,65,1
198748,1349,272,64,64,0
229724,1570,329,64,68,4
230236,1577,315,64,64,0
262501,1808,382,64,72,8
261273,1592,349,64,75,11
264346,1458,314,64,64,0
221850,1581,343,64,64,0
232090,1775,374,64,67,3
245402,1546,328,64,67,3
236471,1736,370,64,71,7
245431,913,353,64,66,2
261222,1585,344,64,80,16
247479,1076,359,64,79,15
178022,1119,367,64,64,0
224870,1557,331,64,64,0
197990,1741,367,64,64,0
255333,1446,309,64,73,9
252773,1008,351,64,79,15
252261,1680,359,64,72,8
252313,1779,379,64,68,4
244120,1000,349,64,64,0
172952,1674,364,64,64,0
226197,1713,367,64,64,0
255123,1366,294,64,65,1
252052,1658,353,64,74,10
258708,1347,293,64,77,13
262293,1586,347,64,69,5
205973,1577,348,64,64,0
223381,1735,358,64,64,0
242325,1643,360,64,66,2
184471,1823,371,64,64,0
254357,1591,350,64,69,5
163990,1594,340,64,64,0
237206,1565,334,64,65,1
252310,1684,359,64,71,7
256918,1548,341,64,79,15
231063,1850,388,64,69,5
225125,1804,393,64,68,4
257380,1560,347,64,79,15
242012,1601,358,64,66,2
247140,1770,371,64,76,12
247136,1554,345,64,72,8
245856,1524,334,64,73,9
233056,1451,319,64,68,4
225376,1791,372,64,64,0
213856,1719,379,64,64,0
259679,1736,370,64,84,20
262495,1616,340,64,65,1
256862,1638,360,64,76,12
238686,1631,358,64,64,0
226654,1616,351,64,66,2
212574,1661,349,64,64,0
229981,1764,378,64,68,4
221789,1649,360,64,64,0
258652,1539,332,64,67,3
254556,1470,344,64,76,12
260704,1450,317,64,74,10
198497,1439,311,64,64,0
223073,1611,347,64,64,0
193123,1425,310,64,64,0
177508,1063,357,64,64,0
237924,1541,341,64,69,5
222052,1650,358,64,64,0
207716,1471,302,64,64,0
204644,1661,359,64,64,0
200292,1725,362,64,64,0
242531,1773,384,64,78,14
255585,1639,360,64,68,4
240227,1725,378,64,72,8
237155,1611,344,64,71,7
233315,1799,393,64,69,5
218467,1650,362,64,64,0
259682,1510,330,64,72,8
258146,1458,308,64,64,0
262503,1681,370,64,75,11
210898,1690,363,64,67,3
237927,1113,366,64,71,7
192572,1684,364,64,64,0
247356,1500,327,64,64,0
212540,1642,335,64,64,0
210492,1732,358,64,64,0
258619,1652,353,64,76,12
256059,1552,335,64,70,6
251451,1385,301,64,75,11
244795,1694,366,64,78,14
223186,1762,367,64,69,5
169938,1709,357,64,64,0
238802,1748,367,64,64,0
243666,1776,385,64,73,9
247506,924,350,64,74,10
122066,1489,307,64,64,0
254418,1656,363,64,65,1
193746,1766,370,64,64,0
262355,1498,330,64,64,0
221651,1660,353,64,64,0
259795,1567,343,64,72,8
232916,1741,364,64,64,0
253244,1188,358,64,64,0
241213,1704,373,64,69,5
232576,1555,332,64,64,0
259901,1505,325,64,70,6
210498,1777,383,64,64,0
205378,1077,361,64,65,1
199234,1716,370,64,64,0
258625,1399,306,64,72,8
263233,1591,354,64,75,11
261696,1463,322,64,69,5
259904,957,341,64,70,6
191552,1633,331,64,64,0
190528,1794,366,64,64,0
242240,1701,362,64,76,12
231488,1718,375,64,64,0
228928,1429,309,64,69,5
260415,1550,329,64,81,17
246847,1793,387,64,71,7
213823,1493,311,64,64,0
256830,1627,334,64,77,13
241982,1739,367,64,74,10
234814,1650,357,64,75,11
211006,1717,373,64,64,0
233172,1686,365,64,64,0
243412,1706,376,64,71,7
246740,902,336,64,75,11
182228,1666,353,64,64,0
253145,1620,359,64,72,8
190425,1632,333,64,64,0
206554,1584,350,64,65,1
232922,1691,374,64,64,0
263131,1552,342,64,66,2
236251,1763,370,64,64,0
251355,1395,303,64,71,7
253147,1373,295,64,67,3
207836,1773,372,64,64,0
216540,1134,351,64,68,4
195036,1604,327,64,64,0
205533,1689,367,64,64,0
263390,1524,333,64,80,16
263646,1546,331,64,80,16
264158,1587,350,64,77,13
264414,1593,344,64,75,11
202974,1872,401,64,64,0
209886,1813,383,64,64,0
220894,1711,362,64,70,6
246745,1713,373,64,77,13
209369,1589,346,64,64,0
263897,1510,331,64,72,8
181205,1736,377,64,64,0
254932,1456,326,64,65,1
263637,1681,363,64,80,16
221141,1667,373,64,69,5
226261,1766,374,64,70,6
233941,1586,341,64,74,10
243669,1570,338,64,73,9
244181,1627,358,64,71,7
246229,1696,366,64,74,10
255445,1518,337,64,73,9
262617,1661,348,64,67,3
264406,1501,322,64,78,14
242390,1645,358,64,71,7
189910,1643,352,64,64,0
231383,999,363,64,69,5
236503,1788,378,64,64,0
259031,1558,339,64,85,21
262360,1647,357,64,68,4
221656,1606,350,64,64,0
223810,1775,373,64,70,6
225858,1138,363,64,69,5
237378,1636,356,64,72,8
251549,1659,351,64,75,11
221859,1747,382,64,64,0
220579,1784,375,64,69,5
206243,1645,359,64,64,0
255906,1455,327,64,74,10
241058,1849,391,64,64,0
237218,1720,367,64,68,4
224418,1771,380,64,69,5
213665,1735,366,64,69,5
260256,1640,342,64,68,4
253600,1694,362,64,64,0
243360,1753,378,64,74,10
231840,1737,367,64,71,7
237215,1525,324,64,67,3
230303,1672,347,64,64,0
219551,1720,371,64,69,5
259486,1565,341,64,79,15
226206,1805,380,64,69,5
225694,1619,351,64,70,6
263582,1681,363,64,79,15
239779,1488,326,64,73,9
247459,1415,313,64,69,5
255907,1596,349,64,66,2
228261,1341,276,64,64,0
247463,1504,326,64,81,17
228519,1533,336,64,70,6
250790,1563,340,64,76,12
208294,1790,376,64,64,0
254117,1469,309,64,78,14
251045,1862,386,64,64,0
241829,1419,303,64,71,7
232101,1004,348,64,72,8
213413,1080,359,64,66,2
193443,1088,352,64,64,0
210341,1673,359,64,64,0
262565,1412,304,64,70,6
251044,1616,356,64,64,0
243876,1684,368,64,70,6
243620,1581,337,64,70,6
241828,1508,331,64,71,7
236196,1655,352,64,64,0
233892,1512,333,64,72,8
260253,1403,303,64,64,0
246685,1540,338,64,77,13
207427,1186,367,64,64,0
243357,1669,367,64,76,12
257349,1700,361,64,80,16
255557,1517,331,64,70,6
227909,1045,351,64,65,1
207429,1675,364,64,65,1
195396,1648,356,64,64,0
254788,1527,331,64,75,11
247876,1688,361,64,78,14
246852,1402,305,64,74,10
226116,1524,335,64,70,6
223044,1440,308,64,64,0
262724,1558,338,64,66,2
257091,1583,341,64,75,11
190275,1400,296,64,64,0
254787,1671,362,64,77,13
246595,1697,360,64,64,0
242755,1526,332,64,72,8
240195,1506,316,64,64,0
169539,1445,301,64,64,0
212803,1671,333,64,65,1
252742,1612,347,64,66,2
192070,1438,312,64,66,2
211271,1554,334,64,66,2
243355,1662,369,64,74,10
224669,1756,377,64,64,0
252316,1464,321,64,72,8
226716,1670,364,64,70,6
261531,1501,333,64,78,14
261019,1700,362,64,64,0
182427,1602,329,64,64,0
247195,1759,371,64,65,1
246427,1536,334,64,69,5
239003,1658,364,64,71,7
212039,1739,377,64,64,0
235931,951,348,64,71,7
229019,1607,349,64,67,3
226459,1578,340,64,68,4
256666,1404,309,64,81,17
248474,1644,359,64,82,18
264008,1517,330,64,69,5
244807,988,359,64,66,2
212807,1705,367,64,64,0
156894,1837,371,64,64,0
245290,1507,321,64,75,11
247143,1577,329,64,67,3
262421,1659,357,64,64,0
242965,1508,330,64,73,9
185109,1821,384,64,64,0
203542,1678,354,64,64,0
263378,1469,320,64,70,6
218633,1663,363,64,67,3
204297,1678,362,64,64,0
232926,1623,328,64,64,0
252382,1772,381,64,72,8
258014,1693,358,64,75,11
199647,1802,371,64,64,0
180593,1709,378,64,64,0
238961,1508,341,64,64,0
232817,998,349,64,67,3
227953,1547,329,64,67,3
214641,1749,359,64,66,2
260464,1716,367,64,75,11
260208,1738,357,64,64,0
259696,1430,323,64,64,0
245360,1754,380,64,68,4
222229,1115,368,64,65,1
256276,1039,362,64,65,1
215594,1733,368,64,64,0
254228,1500,323,64,72,8
262929,1585,355,64,71,7
212753,1821,391,64,66,2
234769,1783,392,64,69,5
172561,1795,376,64,64,0
262418,1724,362,64,64,0
264210,1757,367,64,77,13
223506,1719,367,64,65,1
239634,1524,340,64,70,6
246546,1744,377,64,72,8
246802,1771,389,64,66,2
256275,1494,334,64,64,0
190995,1659,361,64,64,0
259859,1677,349,64,67,3
211732,1573,342,64,64,0
234260,1015,354,64,72,8
242196,1596,353,64,72,8
243476,1125,356,64,72,8
245268,1719,375,64,73,9
246804,1704,357,64,68,4
228464,1704,370,64,64,0
262256,1533,330,64,69,5
259183,1644,364,64,67,3
255855,1755,369,64,68,4
177515,1608,344,64,64,0
242283,1723,367,64,69,5
227947,1790,379,64,69,5
260202,1707,371,64,73,9
252778,1717,370,64,67,3
247658,1690,363,64,78,14
235626,1616,345,64,64,0
239977,1546,329,64,75,11
173673,1811,364,64,64,0
229225,1566,350,64,67,3
215401,1845,390,64,64,0
257640,1067,355,64,66,2
253288,1441,319,64,71,7
251752,978,352,64,80,16
237160,1543,351,64,70,6
225128,1780,372,64,64,0
223080,1679,365,64,64,0
260199,1701,365,64,64,0
252775,1620,343,64,68,4
264044,1451,310,64,77,13
211820,1708,376,64,64,0
245100,1470,320,64,73,9
245870,1561,339,64,78,14
253039,1487,335,64,66,2
237935,1067,352,64,77,13
231535,1711,369,64,68,4
229743,1694,370,64,66,2
228207,1851,398,64,64,0
223599,1754,368,64,69,5
257646,1646,346,64,64,0
246382,1626,356,64,67,3
222574,1686,359,64,64,0
260204,1488,324,64,70,6
253549,1671,369,64,68,4
251757,1559,337,64,73,9
251501,1791,377,64,71,7
245613,1733,360,64,71,7
244589,1684,359,64,71,7
235885,1663,351,64,70,6
225133,1780,372,64,67,3
222829,1056,356,64,69,5
259856,1633,353,64,69,5
245264,1537,335,64,72,8
230928,1292,282,64,64,0
238114,1659,353,64,74,10
202534,1636,352,64,64,0
200742,1323,289,64,66,2
264230,1542,334,64,78,14
261413,1597,361,64,69,5
238629,1507,335,64,71,7
231973,1752,370,64,71,7
221989,1612,352,64,65,1
221477,1706,367,64,64,0
262437,1340,278,64,70,6
251684,1430,315,64,66,2
250916,994,353,64,69,5
248100,1684,365,64,64,0
246564,1377,286,64,70,6
242212,1735,378,64,64,0
237860,1649,358,64,72,8
226084,1533,343,64,71,7
220964,1801,381,64,69,5
214308,1743,375,64,65,1
245539,1732,369,64,76,12
236582,1729,362,64,64,0
237350,1581,346,64,64,0
244262,1080,361,64,75,11
210217,1604,346,64,64,0
210474,1607,340,64,65,1
247081,1572,346,64,77,13
239657,896,339,64,67,3
236841,1740,370,64,67,3
230697,1744,372,64,69,5
229161,1505,326,64,64,0
224297,1627,359,64,69,5
215593,1747,359,64,66,2
209193,1089,360,64,64,0
253734,1474,321,64,69,5
263209,1490,318,64,67,3
252456,938,345,64,67,3
248360,1678,366,64,73,9
247336,1754,369,64,76,12
253223,1728,389,64,72,8
235815,1723,371,64,73,9
213543,1524,328,64,65,1
205863,1528,327,64,64,0
262691,1631,353,64,66,2
211234,1611,341,64,67,3
210192,1598,348,64,64,0
259361,1614,357,64,72,8
228363,1463,309,64,68,4
210700,1808,379,64,64,0
146188,1753,371,64,64,0
215052,1571,337,64,64,0
230412,1627,330,64,64,0
258316,1624,346,64,81,17
260364,1487,327,64,65,1
260876,1746,383,64,82,18
261388,1363,295,64,69,5
222221,1028,351,64,66,2
222477,1773,377,64,69,5
223501,1727,375,64,66,2
184077,1626,355,64,64,0
257549,1622,345,64,72,8
260365,1653,357,64,70,6
262927,1775,385,64,64,0
241935,1509,325,64,70,6
245263,1550,332,64,67,3
259855,1536,329,64,77,13
209675,1589,350,64,65,1
258570,1546,335,64,72,8
118794,1058,349,64,64,0
246816,1587,330,64,73,9
259105,1492,314,64,79,15
258081,1527,328,64,79,15
244513,1651,354,64,73,9
240673,1608,351,64,73,9
170785,943,353,64,64,0
223265,1299,270,64,67,3
207905,1775,370,64,64,0
256544,1541,332,64,81,17
246560,1535,328,64,67,3
242954,1687,369,64,66,2
242720,1454,322,64,69,5
213280,1831,392,64,64,0
207904,1640,344,64,64,0
221961,1588,342,64,65,1
252169,1590,349,64,75,11
204554,1582,348,64,64,0
211978,1548,326,64,67,3
240906,1539,333,64,76,12
242560,1438,308,64,67,3
52326,1103,347,64,64,0
229504,1773,380,64,67,3
230140,1380,307,64,70,6
200196,1698,363,64,64,0
216836,1788,370,64,64,0
241924,1711,363,64,69,5
180740,1492,322,64,64,0
208645,1654,352,64,66,2
215301,1406,305,64,68,4
162053,1481,324,64,64,0
238085,1725,362,64,71,7
258565,1594,337,64,67,3
215302,1810,367,64,67,3
220422,1677,361,64,64,0
228870,1488,324,64,70,6
256518,1509,334,64,71,7
196871,1566,319,64,64,0
263943,1727,373,64,82,18
257283,1762,368,64,72,8
191235,1678,359,64,64,0
189955,1006,347,64,64,0
264195,1499,319,64,73,9
222466,1588,344,64,71,7
234242,1727,377,64,72,8
237570,1302,289,64,72,8
242690,1541,341,64,71,7
257794,1059,360,64,67,3
262403,1682,356,64,68,4
224515,1704,378,64,68,4
254723,1489,330,64,72,8
229123,1765,385,64,68,4
230403,1389,286,64,64,0
232963,1685,369,64,64,0
242179,966,356,64,75,11
244995,1371,301,64,64,0
252675,1403,318,64,67,3
235527,1691,365,64,67,3
241415,1568,338,64,74,10
182023,926,348,64,64,0
252925,1652,349,64,74,10
257534,1672,362,64,84,20
253694,1605,345,64,68,4
248574,1649,345,64,76,12
233214,1594,352,64,66,2
258557,1767,379,64,73,9
257021,1426,313,64,71,7
235005,1741,379,64,65,1
259582,1647,350,64,78,14
227837,1531,332,64,70,6
208637,1779,383,64,64,0
259068,1657,364,64,74,10
257020,1511,345,64,70,6
245756,1583,347,64,73,9
177404,1676,343,64,64,0
259070,1785,383,64,77,13
225279,1747,380,64,67,3
184071,1678,338,64,64,0
193771,1785,380,64,64,0
263944,1606,344,64,67,3
232456,1470,321,64,64,0
232712,1786,372,64,70,6
237576,948,343,64,69,5
244488,1718,368,64,75,11
199916,1474,317,64,64,0
251912,1629,352,64,74,10
238079,1495,337,64,70,6
252936,1639,342,64,76,12
198153,1854,382,64,64,0
263945,1718,365,64,81,17
251690,1694,367,64,73,9
255274,1360,295,64,67,3
259583,1680,369,64,81,17
260865,1643,353,64,65,1
235521,1759,367,64,71,7
208129,1469,303,64,65,1
253303,1510,311,64,64,0
118646,1727,356,64,64,0
259190,1733,370,64,78,14
194678,1373,296,64,64,0
216183,1785,384,64,64,0
223095,1643,336,64,65,1
237943,1523,333,64,66,2
257399,1537,333,64,84,20
225910,1428,303,64,71,7
260215,1667,363,64,69,5
204920,1760,373,64,64,0
211833,1863,392,64,64,0
244089,1490,338,64,72,8
245625,1708,369,64,70,6
246393,1692,342,64,64,0
227446,1661,335,64,64,0
252789,918,341,64,80,16
258937,1712,368,64,79,15
255254,1536,341,64,65,1
238103,1581,336,64,66,2
207639,1857,393,64,64,0
203287,1743,375,64,65,1
200471,1677,354,64,64,0
262423,1467,309,64,69,5
196887,1674,339,64,64,0
253462,1624,348,64,74,10
179573,1019,342,64,64,0
231028,973,349,64,71,7
232564,919,341,64,64,0
251764,1686,382,64,71,7
257396,1546,329,64,75,11
258420,977,334,64,74,10
239989,1606,348,64,71,7
253817,1595,339,64,64,0
204666,1788,373,64,64,0
263169,1656,352,64,82,18
203264,1462,314,64,64,0
257151,1579,339,64,72,8
257919,1738,365,64,78,14
213120,1687,368,64,65,1
222848,1681,362,64,67,3
156438,1082,351,64,64,0
247062,1639,356,64,72,8
212736,1664,362,64,67,3
246143,1641,353,64,74,10
232704,1478,335,64,68,4
234496,1568,337,64,64,0
236800,1605,344,64,70,6
176384,1123,350,64,64,0
254464,1583,348,64,64,0
255232,1382,297,64,68,4
255871,1549,333,64,70,6
173695,1472,304,64,64,0
216698,1583,335,64,64,0
244859,1527,339,64,72,8
238458,1697,369,64,75,11
238970,1774,384,64,64,0
251258,1405,307,64,73,9
258426,1468,325,64,66,2
215419,1555,349,64,67,3
230523,1647,333,64,64,0
223868,1063,357,64,68,4
248702,1683,368,64,64,0
229756,1463,323,64,70,6
247420,1609,345,64,75,11
259964,1450,312,64,70,6
256893,1469,322,64,73,9
192125,1631,348,64,64,0
259453,1482,333,64,70,6
241404,1424,314,64,64,0
263164,1596,345,64,67,3
246295,1621,354,64,78,14
262652,1492,325,64,73,9
238649,1662,364,64,64,0
228153,1761,372,64,71,7
225337,1641,358,64,68,4
219449,1799,380,64,68,4
197945,1622,349,64,64,0
214840,1598,343,64,66,2
248119,1626,352,64,75,11
234039,1537,326,64,73,9
241462,1616,347,64,70,6
212022,1037,348,64,64,0
263477,1351,294,64,71,7
258100,1578,332,64,69,5
255028,1694,363,64,69,5
189492,1730,364,64,64,0
250932,1689,371,64,67,3
246329,1563,342,64,72,8
251449,971,333,64,74,10
194617,1641,356,64,64,0
264105,1497,320,64,75,11
187818,1809,373,64,64,0
232106,1568,340,64,73,9
227498,1570,341,64,65,1
220074,1515,329,64,68,4
261033,1434,301,64,67,3
192937,1548,336,64,64,0
259752,1511,341,64,72,8
221498,1724,374,64,64,0
185256,1736,374,64,64,0
221864,1606,343,64,66,2
199080,1781,369,64,64,0
247354,1474,329,64,72,8
244026,1654,365,64,64,0
233018,1654,361,64,70,6
233012,1582,334,64,69,5
217140,1651,363,64,67,3
202292,1828,381,64,64,0
255532,1536,323,64,80,16
241710,1658,362,64,72,8
173614,1401,292,64,64,0
237102,1765,387,64,68,4
234286,1559,342,64,69,5
246061,1553,332,64,73,9
263725,1501,314,64,65,1
238636,1726,376,64,69,5
184878,1667,360,64,64,0
251435,1464,332,64,70,6
231979,1610,342,64,64,0
152107,1528,322,64,64,0
206635,1815,385,64,64,0
206379,1017,346,64,64,0
228305,1815,379,64,67,3
243246,1518,331,64,74,10
242223,1594,354,64,75,11
257075,1547,337,64,83,19
238642,1791,381,64,65,1
251443,1554,347,64,65,1
183347,1184,363,64,64,0
234803,1015,363,64,72,8
258866,1718,376,64,82,18
254770,1691,367,64,64,0
239410,1008,351,64,70,6
231474,977,336,64,70,6
257839,1661,356,64,67,3
259633,1591,338,64,81,17
245809,1502,327,64,73,9
262449,1749,381,64,70,6
261680,1781,376,64,84,20
222256,1772,378,64,67,3
198704,1729,353,64,64,0
188586,1656,340,64,64,0
190122,1740,362,64,64,0
215211,1567,347,64,67,3
263607,1645,347,64,71,7
226040,1472,313,64,64,0
258039,1734,373,64,67,3
262955,1453,315,64,66,2
256503,1533,328,64,76,12
248311,1600,348,64,64,0
230839,1601,354,64,70,6
262839,1719,362,64,73,9
242424,1587,327,64,74,10
232374,1797,371,64,64,0
223670,1662,359,64,65,1
256949,1662,359,64,78,14
191157,1636,356,64,65,1
238005,1726,357,64,64,0
233397,1587,356,64,71,7
233976,1073,367,64,64,0
177912,1792,365,64,64,0
190644,1381,299,64,64,0
204282,1712,366,64,65,1
255995,1466,322,64,74,10
254203,1616,355,64,70,6
240123,1064,353,64,78,14
238587,1707,366,64,69,5
228091,1537,320,64,71,7
225019,1594,339,64,70,6
262137,1679,363,64,78,14
248824,1673,371,64,72,8
260601,1535,329,64,78,14
253433,1658,363,64,77,13
240633,1524,345,64,69,5
226041,1438,308,64,64,0
205049,1457,305,64,64,0
264697,1760,374,64,76,12
262581,1566,341,64,68,4
232116,1688,351,64,69,5
222379,1761,368,64,73,9
256941,1400,312,64,64,0
255662,1537,334,64,72,8
246958,939,358,64,67,3
244142,1701,364,64,69,5
231342,1462,326,64,67,3
212398,1629,344,64,67,3
261037,1586,343,64,74,10
254637,1752,373,64,65,1
222639,1167,361,64,69,5
246957,1561,342,64,80,16
229036,1519,324,64,65,1
222380,1619,349,64,64,0
254123,1657,358,64,71,7
253611,1674,365,64,64,0
234155,1559,350,64,72,8
257966,1742,370,64,74,10
223151,1686,372,64,69,5
227764,1586,340,64,71,7
247730,1705,356,64,76,12
213428,1195,364,64,64,0
213172,1778,376,64,64,0
260019,1573,337,64,70,6
246451,1570,339,64,72,8
244403,1565,335,64,76,12
254898,1796,375,64,67,3
252593,1681,353,64,75,11
234927,1775,386,64,65,1
251313,1746,367,64,70,6
236209,1574,347,64,71,7
162993,1664,347,64,64,0
200369,1779,374,64,64,0
232624,1721,369,64,64,0
238511,1456,311,64,73,9
241943,1681,374,64,71,7
239997,1501,328,64,72,8
221976,1624,347,64,64,0
228376,1496,330,64,70,6
251634,1762,377,64,71,7
258034,1694,363,64,79,15
223731,1707,367,64,64,0
260339,1734,373,64,69,5
198132,1056,367,64,65,1
210676,995,353,64,69,5
217332,1565,346,64,67,3
248052,1503,316,64,75,11
262389,1560,329,64,64,0
208885,1669,356,64,64,0
222197,1746,375,64,64,0
167925,1563,316,64,64,0
235253,1756,375,64,68,4
243445,1521,331,64,74,10
263670,1392,295,64,74,10
204790,1726,366,64,64,0
231926,1746,384,64,73,9
167926,1707,366,64,64,0
238070,977,351,64,76,12
245750,1377,303,64,72,8
164855,1541,323,64,64,0
184433,1538,317,64,64,0
254065,1522,341,64,75,11
263365,1567,343,64,68,4
216273,1779,383,64,64,0
213969,1706,369,64,65,1
253904,1694,362,64,75,11
212978,1444,311,64,65,1
207858,1679,343,64,64,0
262642,1744,374,64,75,11
234222,1668,351,64,72,8
217160,1868,395,64,64,0
228845,1145,354,64,64,0
238317,1796,386,64,67,3
241133,1538,329,64,64,0
201925,1429,307,64,64,0
180717,1055,358,64,64,0
247021,1633,347,64,75,11
251629,1732,383,64,74,10
255469,1492,324,64,69,5
264430,1028,355,64,78,14
155886,1136,359,64,64,0
230126,1696,373,64,64,0
241646,1606,351,64,75,11
255217,1525,328,64,74,10
51694,1143,353,64,64,0
251630,1628,350,64,67,3
218863,1649,364,64,64,0
220143,1685,348,64,64,0
234991,1765,383,64,71,7
243951,1664,355,64,64,0
259823,1490,315,64,68,4
241648,933,340,64,64,0
251376,1776,381,64,65,1
204017,1802,378,64,64,0
226801,1552,350,64,64,0
238065,1567,344,64,70,6
244688,1494,332,64,67,3
261327,1642,350,64,67,3
203849,1023,353,64,66,2
251343,1416,303,64,70,6
194248,1635,331,64,64,0
188872,1706,370,64,64,0
247496,1471,321,64,71,7
50632,1450,296,64,64,0
211144,1693,369,64,65,1
262344,1546,344,64,69,5
256967,1419,306,64,67,3
251079,1681,364,64,69,5
242423,1770,378,64,77,13
235207,1449,330,64,68,4
225735,1638,345,64,66,2
221383,1673,352,64,65,1
211143,1680,360,64,65,1
206535,1639,348,64,67,3
250822,1729,366,64,78,14
200134,1801,382,64,64,0
251845,1703,371,64,75,11
245751,1418,314,64,72,8
256115,1575,337,64,81,17
238195,1745,381,64,64,0
237683,1517,331,64,73,9
256882,1591,337,64,80,16
202866,1623,326,64,64,0
232901,1688,360,64,71,7
166853,1513,316,64,64,0
222405,1887,396,64,67,3
219845,1660,358,64,65,1
250825,1689,369,64,76,12
190665,1602,345,64,64,0
259273,916,349,64,69,5
208589,1815,378,64,64,0
240335,1672,363,64,64,0
236239,987,347,64,75,11
203215,1004,362,64,66,2
260302,1626,364,64,77,13
259022,1729,369,64,81,17
251086,1723,379,64,64,0
241102,1547,337,64,68,4
240334,1445,315,64,73,9
238286,1628,358,64,70,6
230606,1765,379,64,68,4
260045,1375,296,64,75,11
184013,1655,344,64,64,0
195020,1880,407,64,64,0
247754,1551,345,64,72,8
244684,1587,339,64,73,9
204492,1695,357,64,64,0
259787,1606,353,64,73,9
189387,1096,363,64,64,0
248011,1717,367,64,70,6
178379,1702,355,64,64,0
242635,1568,353,64,75,11
232907,1434,294,64,64,0
212683,1578,336,64,64,0
199627,1738,381,64,64,0
261066,1621,344,64,71,7
248010,1781,376,64,64,0
225864,1750,378,64,69,5
244717,1691,364,64,72,8
212041,1725,359,64,67,3
192540,1628,338,64,64,0
263197,1591,337,64,80,16
213021,1603,346,64,65,1
233245,1771,382,64,71,7
236573,1361,287,64,68,4
240669,1618,352,64,74,10
247325,1669,374,64,80,16
224798,1713,353,64,64,0
228638,1801,384,64,69,5
230942,1503,343,64,73,9
239902,1703,369,64,70,6
262431,1670,349,64,64,0
224543,1079,360,64,70,6
241695,1597,349,64,71,7
245023,1582,335,64,72,8
261663,1368,298,64,70,6
209644,1092,366,64,67,3
226540,1592,346,64,65,1
238060,1035,359,64,74,10
172780,1630,324,64,64,0
242156,1569,347,64,73,9
259820,1601,353,64,69,5
220532,1078,358,64,70,6
264308,1691,363,64,76,12
234072,1673,362,64,70,6
233048,1763,381,64,75,11
260183,1800,385,64,65,1
252247,1484,327,64,69,5
262685,1592,337,64,64,0
252188,1636,342,64,69,5
226633,1675,354,64,69,5
251420,1682,363,64,73,9
236568,920,345,64,72,8
240664,1663,347,64,64,0
259352,964,352,64,73,9
224793,1678,366,64,69,5
225561,1598,343,64,67,3
171033,1118,351,64,64,0
240921,1600,352,64,72,8
253465,1614,361,64,82,18
262938,1543,343,64,76,12
234522,1568,349,64,76,12
176922,1077,370,64,64,0
244250,1517,342,64,68,4
244762,1583,337,64,72,8
245274,1127,360,64,76,12
252442,1661,355,64,75,11
255258,1614,344,64,75,11
241435,1717,373,64,75,11
243739,1731,368,64,64,0
261147,1677,360,64,67,3
261659,1670,367,64,70,6
263452,1719,369,64,67,3
222236,1728,377,64,64,0
223004,1809,380,64,64,0
232476,1581,338,64,68,4
240156,1637,353,64,70,6
247068,1594,334,64,65,1
247580,1824,392,64,69,5
258902,1652,363,64,74,10
211141,1629,342,64,64,0
232017,1397,314,64,66,2
246099,1724,364,64,80,16
240978,1768,372,64,71,7
255825,1551,347,64,74,10
254289,1603,357,64,68,4
179537,1763,355,64,64,0
242513,1657,352,64,64,0
232785,1538,337,64,64,0
257872,1732,369,64,64,0
211536,1785,388,64,65,1
256079,1654,365,64,79,15
228431,1579,345,64,70,6
226127,1469,303,64,66,2
160079,1700,352,64,64,0
236365,1694,367,64,68,4
228685,1669,368,64,67,3
258124,1601,333,64,71,7
255308,975,343,64,71,7
243532,1727,374,64,75,11
227148,1164,354,64,72,8
206412,1095,361,64,66,2
196940,1799,379,64,64,0
250955,1482,324,64,75,11
162891,1797,364,64,64,0
225867,1575,342,64,70,6
256082,1500,328,64,75,11
255314,1586,344,64,73,9
254803,944,335,64,81,17
221270,1748,366,64,65,1
244041,1599,345,64,75,11
260937,1784,380,64,67,3
264266,1608,351,64,84,20
223306,1614,346,64,67,3
257866,1703,366,64,74,10
194122,1624,342,64,64,0
264267,1666,365,64,76,12
257622,1680,361,64,73,9
257110,1392,301,64,75,11
244054,1825,388,64,64,0
243286,1495,332,64,67,3
173654,1878,381,64,64,0
185173,1769,368,64,64,0
248405,1478,324,64,76,12
239957,1765,370,64,64,0
237397,1484,315,64,64,0
19541,1160,349,64,64,0
242260,1357,308,64,75,11
225876,1558,332,64,64,0
262740,1639,346,64,73,9
193875,1645,352,64,64,0
258194,1511,325,63,75,12
232338,1367,291,63,63,0
232082,972,344,63,65,2
232850,1535,353,63,68,5
239506,1465,310,63,70,7
242322,1641,355,63,64,1
233876,1644,357,63,63,0
171923,1738,370,63,63,0
258451,1558,327,63,77,14
201364,1606,343,63,63,0
220306,1648,361,63,64,1
255887,1662,360,63,69,6
205712,1698,363,63,63,0
238736,1535,322,63,74,11
264081,1471,322,63,78,15
235665,1540,334,63,74,11
205972,1530,335,63,63,0
255972,1538,338,63,78,15
253329,1211,362,63,63,0
237713,1515,331,63,63,0
230897,1656,366,63,69,6
218867,1093,358,63,63,0
262387,1638,353,63,63,0
210924,1648,350,63,63,0
231916,1570,343,63,69,6
233196,1831,383,63,63,0
235500,1624,366,63,65,2
236780,890,328,63,67,4
239596,1312,289,63,70,7
241900,1593,340,63,70,7
263661,1494,326,63,72,9
221421,1611,344,63,63,0
232686,1660,363,63,63,0
262383,1672,363,63,67,4
226288,1153,355,63,70,7
186352,1505,323,63,63,0
192496,1497,319,63,63,0
259824,1457,321,63,63,0
263153,1636,363,63,78,15
111503,1661,328,63,63,0
245233,1371,293,63,71,8
202482,1728,372,63,63,0
221938,1754,381,63,67,4
246258,1504,326,63,78,15
252047,1536,337,63,70,7
232365,1055,366,63,63,0
242319,1597,346,63,68,5
238765,1700,366,63,72,9
189868,1763,374,63,63,0
248492,1435,314,63,75,12
208812,1812,378,63,64,1
257195,1648,351,63,71,8
263339,1042,351,63,80,17
247722,1652,346,63,75,12
224426,1409,295,63,66,3
259241,1603,345,63,70,7
254121,1383,302,63,80,17
253609,1549,327,63,71,8
247209,1582,334,63,76,13
240809,961,351,63,78,15
237993,1583,339,63,69,6
258216,1491,318,63,75,12
186536,1794,375,63,63,0
251560,1622,350,63,72,9
229800,1587,348,63,63,0
226728,1608,342,63,67,4
251303,1658,354,63,63,0
248231,1595,345,63,75,12
244647,1521,317,63,70,7
227751,1509,339,63,63,0
264103,1407,309,63,79,16
238509,1581,332,63,71,8
246189,1641,348,63,64,1
180902,1460,301,63,63,0
247213,1486,328,63,74,11
264428,1606,338,63,68,5
242055,1601,356,63,64,1
239495,1730,371,63,67,4
221831,1714,361,63,63,0
263559,1692,362,63,76,13
244870,1610,351,63,72,9
240262,1734,367,63,68,5
239750,1398,295,63,63,0
246704,1049,338,63,74,11
241328,1530,338,63,72,9
210352,1559,341,63,64,1
208304,1677,358,63,63,0
254383,1713,364,63,63,0
251055,1671,350,63,64,1
238767,1709,366,63,73,10
235439,1480,331,63,68,5
228783,1692,364,63,70,7
223663,1636,359,63,66,3
262575,1472,315,63,73,10
264110,1576,341,63,81,18
190637,1380,299,63,63,0
254893,1676,373,63,68,5
252077,1659,359,63,67,4
256678,1761,371,63,70,7
173734,1512,331,63,63,0
204175,1569,348,63,63,0
239752,1399,311,63,65,2
260232,1627,351,63,82,19
263049,1569,335,63,70,7
235913,1718,363,63,71,8
258185,1539,321,63,81,18
259209,1553,331,63,75,12
185226,1600,345,63,63,0
258442,1690,356,63,77,14
263563,1540,346,63,67,4
207499,1654,346,63,63,0
251787,1544,338,63,63,0
221836,1583,348,63,63,0
241036,1605,340,63,74,11
182156,1667,347,63,63,0
253836,1132,354,63,66,3
155533,1528,323,63,63,0
253325,1724,363,63,63,0
189325,1742,363,63,63,0
255373,1420,316,63,78,15
261261,1553,330,63,71,8
228238,1478,313,63,69,6
239502,1398,303,63,70,7
243598,1559,338,63,67,4
248718,1541,341,63,68,5
242312,1523,330,63,66,3
222600,1113,352,63,68,5
238758,1674,358,63,76,13
259975,1568,329,63,66,3
232102,1349,289,63,74,11
211622,1464,305,63,64,1
193957,1761,377,63,63,0
191909,1594,345,63,63,0
250789,1540,341,63,75,12
248485,1425,306,63,63,0
247205,923,331,63,63,0
243365,1426,307,63,66,3
232357,1669,357,63,68,5
224421,1623,355,63,66,3
259747,1526,333,63,74,11
251811,1579,327,63,71,8
251555,1689,366,63,75,12
261364,1724,365,63,71,8
260340,1594,346,63,79,16
244724,1659,350,63,71,8
234228,1037,346,63,71,8
258291,1648,349,63,72,9
244979,1598,353,63,66,3
236787,1577,339,63,73,10
231411,1622,350,63,71,8
254087,1479,319,63,77,14
257415,1591,338,63,66,3
203500,1762,370,63,64,1
226759,1332,282,63,68,5
259563,1572,338,63,75,12
262236,1638,353,63,74,11
260186,1617,353,63,68,5
239451,1719,370,63,72,9
251995,859,335,63,73,10
255835,1693,364,63,69,6
256859,1531,343,63,76,13
259163,1508,331,63,76,13
228188,1609,348,63,63,0
257886,1529,331,63,76,13
236381,1476,331,63,66,3
244829,1624,346,63,65,2
248157,1781,369,63,73,10
263006,1633,342,63,74,11
219486,1625,359,63,66,3
221534,1776,367,63,65,2
246874,1677,371,63,73,10
234586,1745,367,63,63,0
232538,1486,326,63,68,5
215130,1145,350,63,63,0
208474,1507,319,63,63,0
262490,1430,300,63,64,1
254297,935,344,63,75,12
246873,1399,306,63,72,9
236633,1715,369,63,68,5
252248,1746,374,63,74,11
259159,1485,327,63,81,18
242263,1619,360,63,72,9
235607,1783,375,63,63,0
246614,1422,295,63,63,0
245846,1637,355,63,71,8
233046,1667,370,63,68,5
258133,970,343,63,68,5
189278,1747,364,63,63,0
259422,1467,320,63,81,18
257528,1536,334,63,71,8
263671,1685,355,63,71,8
253794,1462,317,63,63,0
225781,1736,369,63,68,5
256501,1592,352,63,72,9
264438,1508,328,63,79,16
251638,1569,326,63,63,0
258550,1636,348,63,74,11
263927,1634,362,63,66,3
213855,1544,330,63,64,1
264439,1631,344,63,73,10
233719,1622,350,63,63,0
234743,1566,332,63,72,9
255479,1558,339,63,68,5
239352,1609,356,63,63,0
254456,1617,339,63,64,1
247138,1530,323,63,72,9
243810,948,336,63,72,9
235618,1638,359,63,69,6
233570,1540,326,63,66,3
227682,1745,371,63,69,6
199010,1518,322,63,63,0
188001,1720,382,63,63,0
244321,1687,370,63,65,2
238177,1772,375,63,71,8
264289,1573,337,63,75,12
259680,1715,370,63,80,17
258400,1753,384,63,66,3
262496,1586,340,63,63,0
262240,1627,342,63,75,12
257887,1651,355,63,67,4
257631,1539,347,63,69,6
251999,1677,368,63,74,11
256597,1469,321,63,67,4
224597,1633,359,63,66,3
210773,1619,350,63,64,1
256128,1646,344,63,79,16
250754,901,337,63,77,14
238210,1570,340,63,63,0
211074,1372,290,63,63,0
205441,1053,353,63,64,1
264321,1590,349,63,72,9
259456,1691,362,63,75,12
180352,1750,369,63,63,0
209493,1443,322,63,65,2
245376,1658,363,63,76,13
243840,1630,350,63,72,9
172928,1738,360,63,63,0
260991,1532,333,63,70,7
257407,1574,343,63,70,7
191871,1824,366,63,63,0
236675,1589,342,63,70,7
240259,1724,368,63,69,6
257411,1720,374,63,74,11
263556,1438,309,63,72,9
205956,1581,347,63,63,0
230532,1665,359,63,63,0
202117,1661,370,63,64,1
238981,1682,372,63,64,1
243589,1631,350,63,72,9
245125,1673,353,63,73,10
192901,1561,324,63,63,0
258437,1506,333,63,76,13
260741,1510,335,63,69,6
262790,1554,338,63,69,6
224902,1659,365,63,68,5
226950,1536,331,63,66,3
238726,1607,349,63,71,8
254847,1429,322,63,68,5
247679,1585,342,63,73,10
257150,1599,352,63,66,3
254586,1551,343,63,75,12
260692,1564,345,63,77,14
256852,1511,330,63,76,13
251988,1705,362,63,74,11
264693,1630,354,63,63,0
261620,1681,353,63,74,11
264313,1594,345,63,68,5
246649,1641,354,63,78,15
254841,1590,349,63,68,5
257145,1539,334,63,70,7
193913,1063,329,63,63,0
194937,1477,326,63,63,0
261753,1547,332,63,80,17
244858,1669,355,63,71,8
251002,1623,358,63,66,3
216699,1619,333,63,69,6
243838,1607,347,63,74,11
235643,1447,317,63,66,3
239995,1636,353,63,72,9
262780,1745,355,63,63,0
216444,1626,338,63,63,0
246396,1592,343,63,76,13
257916,1643,343,63,75,12
262525,1586,343,63,70,7
263549,1541,341,63,76,13
257917,1715,359,63,74,11
263550,1478,318,63,71,8
199294,1666,354,63,63,0
219518,1759,371,63,63,0
219774,1541,323,63,69,6
241534,1462,319,63,70,7
255992,1516,324,63,67,4
259064,1480,332,63,77,14
255211,1550,335,63,70,7
252096,1670,361,63,63,0
258497,1585,341,63,72,9
254401,1111,356,63,63,0
239553,1702,371,63,74,11
210113,1776,373,63,64,1
207809,1573,337,63,63,0
262337,1442,324,63,72,9
250816,1644,358,63,75,12
242366,1618,351,63,72,9
242624,1660,363,63,66,3
233920,1484,313,63,68,5
237503,1625,354,63,74,11
231103,1702,363,63,68,5
195262,1562,329,63,63,0
254654,1384,300,63,70,7
262338,1572,342,63,72,9
200898,1825,381,63,63,0
233410,1449,317,63,63,0
238786,1667,360,63,68,5
259010,1539,340,63,63,0
260034,1336,290,63,63,0
260546,1566,333,63,76,13
211395,1740,363,63,63,0
246723,1798,395,63,74,11
246979,1473,325,63,76,13
251075,1629,345,63,73,10
254403,1523,347,63,63,0
262340,1398,312,63,70,7
248772,1632,346,63,77,14
254148,1517,335,63,71,8
257732,1693,364,63,63,0
202949,1670,370,63,63,0
251582,1674,353,63,72,9
236222,1617,351,63,69,6
261880,1567,322,63,70,7
211434,1417,315,63,63,0
228584,1764,378,63,68,5
262889,1479,318,63,81,18
227817,1704,368,63,64,1
230121,1583,349,63,66,3
182761,1080,337,63,63,0
264170,888,337,63,76,13
231914,977,342,63,70,7
222654,1607,354,63,67,4
243178,1751,379,63,71,8
262635,1628,351,63,65,2
263659,1577,350,63,81,18
213483,1018,336,63,63,0
216299,1639,360,63,66,3
232939,1645,344,63,67,4
254695,1661,357,63,75,12
252391,1540,325,63,73,10
238055,1624,355,63,69,6
228327,1676,355,63,63,0
222183,1593,351,63,63,0
204007,1609,347,63,63,0
111590,1753,377,63,63,0
240358,1658,359,63,70,7
234982,1641,353,63,68,5
261308,1600,342,63,66,3
264381,1700,351,63,63,0
221373,1657,353,63,63,0
231101,1655,366,63,66,3
234173,1660,361,63,67,4
239805,1299,273,63,65,2
241085,1683,359,63,72,9
187837,1591,340,63,63,0
237253,1665,361,63,68,5
244933,1586,336,63,76,13
246725,943,341,63,63,0
219133,1837,407,63,63,0
242684,1569,342,63,69,6
244476,1397,293,63,75,12
248572,1611,340,63,75,12
250876,1618,342,63,69,6
258812,1479,322,63,75,12
259580,927,349,63,76,13
235773,1697,377,63,70,7
259781,1440,323,63,66,3
192765,1587,332,63,63,0
259069,1527,338,63,77,14
232446,1685,359,63,72,9
243966,1427,315,63,72,9
247806,1634,348,63,73,10
253438,1716,365,63,70,7
202492,1575,347,63,63,0
201212,1533,329,63,63,0
260091,1674,363,63,76,13
259323,1586,345,63,73,10
250875,1431,329,63,68,5
240891,1631,350,63,67,4
238843,1765,374,63,70,7
236027,1540,336,63,70,7
227579,1573,336,63,68,5
219643,1095,348,63,67,4
192761,1693,359,63,63,0
257273,946,339,63,80,17
246009,1595,344,63,76,13
236025,1512,328,63,65,2
224761,1110,349,63,68,5
206073,1627,361,63,64,1
200953,1760,369,63,63,0
261374,1688,364,63,84,21
228607,1045,360,63,68,5
232447,998,341,63,63,0
264448,1652,356,63,66,3
264134,1644,357,63,73,10
207558,1731,366,63,63,0
215494,1607,355,63,66,3
248774,1724,373,63,70,7
253638,1152,361,63,63,0
255174,1610,341,63,76,13
260294,1514,334,63,64,1
212167,1670,359,63,68,5
244708,1573,351,63,69,6
256711,1693,363,63,70,7
263880,935,344,63,77,14
216264,1011,342,63,66,3
232648,1538,336,63,68,5
263680,1549,339,63,66,3
223744,1695,364,63,63,0
189695,1691,350,63,63,0
225280,1193,371,63,68,5
245248,1652,349,63,63,0
248576,1569,348,63,75,12
251136,1090,347,63,73,10
186112,1649,356,63,63,0
206081,1647,361,63,65,2
222209,1340,283,63,67,4
240385,1721,359,63,72,9
242433,1572,339,63,73,10
245761,1685,362,63,74,11
255489,1581,343,63,68,5
202498,1700,361,63,63,0
256741,1753,368,63,64,1
179685,1079,359,63,63,0
189924,1639,351,63,63,0
255377,1631,356,63,78,15
239076,902,341,63,75,12
231197,1722,362,63,64,1
252225,1595,352,63,70,7
231233,1745,372,63,68,5
223041,1048,349,63,65,2
259136,1701,365,63,75,12
256064,1526,338,63,76,13
254784,1535,326,63,79,16
248128,1489,330,63,73,10
246848,1602,348,63,71,8
246336,1661,356,63,80,17
233280,1531,336,63,63,0
225600,1710,362,63,64,1
260159,1435,314,63,73,10
193087,1774,377,63,63,0
256831,1546,331,63,77,14
235071,1001,339,63,73,10
261438,1572,344,63,75,12
260926,1500,336,63,76,13
259902,1521,328,63,63,0
255038,1514,329,63,68,5
156478,1738,348,63,63,0
260413,1553,340,63,71,8
251197,1491,325,63,66,3
219453,1666,349,63,65,2
254529,1573,346,63,80,17
201026,1424,300,63,63,0
204098,1650,346,63,63,0
245018,1442,321,63,78,15
259356,1615,345,63,84,21
257820,1580,337,63,63,0
190492,1747,387,63,63,0
248860,895,335,63,63,0
248604,1654,346,63,72,9
227612,1697,362,63,63,0
197148,1783,376,63,63,0
230171,1171,364,63,63,0
211227,1627,347,63,63,0
261402,1732,359,63,63,0
212805,1636,353,63,63,0
234050,899,342,63,68,5
205893,1626,342,63,63,0
261444,1551,347,63,81,18
254020,1692,362,63,72,9
252996,1648,351,63,66,3
252740,1484,323,63,72,9
224324,1544,339,63,67,4
224068,1141,363,63,64,1
261443,1573,330,63,75,12
236867,947,339,63,71,8
213571,1718,382,63,63,0
257084,1726,369,63,80,17
242748,1627,356,63,69,6
257083,1548,335,63,78,15
215657,1433,324,63,63,0
223851,1728,362,63,63,0
218731,1541,329,63,63,0
262507,1526,336,63,73,10
190826,1553,328,63,63,0
214634,1811,378,63,64,1
209002,1106,353,63,64,1
197226,1769,369,63,63,0
261993,1707,361,63,82,19
230505,1602,318,63,63,0
221801,1821,379,63,63,0
191848,1091,351,63,63,0
238699,931,334,63,64,1
256104,1643,359,63,78,15
231016,1458,310,63,68,5
224616,1716,365,63,63,0
255079,1070,353,63,77,14
253543,1617,350,63,69,6
251495,1434,298,63,63,0
233575,1567,347,63,63,0
217191,1683,360,63,63,0
190822,1054,340,63,65,2
248166,1724,368,63,71,8
225387,1586,344,63,68,5
248171,1368,290,63,77,14
247611,867,330,63,71,8
213305,1470,318,63,63,0
230971,1025,359,63,68,5
221499,1721,368,63,63,0
262971,1548,330,63,68,5
260410,1675,358,63,67,4
239418,1639,362,63,71,8
235322,1674,355,63,63,0
253497,873,325,63,76,13
232505,942,337,63,63,0
231993,950,333,63,63,0
219705,995,344,63,67,4
247352,1546,326,63,77,14
251499,1532,335,63,71,8
235064,1473,326,63,70,7
228152,1455,315,63,68,5
225336,1591,360,63,66,3
212792,1488,332,63,63,0
260663,1709,358,63,75,12
255031,1519,336,63,71,8
198252,1701,368,63,63,0
262508,1627,353,63,75,12
196972,1363,301,63,63,0
259179,1558,351,63,73,10
225053,1706,372,63,72,9
235037,1575,351,63,69,6
237414,968,346,63,66,3
246301,1656,356,63,73,10
215601,1670,354,63,63,0
202033,1773,377,63,63,0
257072,1463,326,63,78,15
248880,1520,342,63,72,9
247856,1656,359,63,70,7
235056,1654,344,63,68,5
258607,1697,366,63,70,7
246063,1691,368,63,75,12
238127,1518,317,63,68,5
237871,1706,354,63,74,11
236591,1561,339,63,74,11
262703,1433,312,63,63,0
239406,1711,349,63,70,7
212782,1753,381,63,67,4
207918,1569,345,63,63,0
254765,1614,354,63,66,3
227629,1673,361,63,71,8
262445,1501,326,63,64,1
256044,1658,347,63,73,10
247084,1643,355,63,70,7
244524,955,339,63,67,4
216620,1702,363,63,63,0
264236,1565,331,63,77,14
229169,1644,353,63,67,4
245553,1483,330,63,74,11
254001,1727,365,63,74,11
237875,1403,290,63,72,9
202551,1612,333,63,63,0
199479,1525,332,63,63,0
261174,1548,336,63,70,7
248118,1611,343,63,76,13
246326,1797,384,63,75,12
263733,1477,329,63,69,6
195124,1679,364,63,63,0
251956,1616,349,63,72,9
239668,1616,342,63,74,11
261427,1505,327,63,63,0
231987,1366,296,63,63,0
256049,1596,338,63,71,8
230963,1670,352,63,64,1
225075,1649,354,63,64,1
199475,1758,375,63,63,0
263475,1511,325,63,72,9
256306,1621,338,63,81,18
255538,1370,309,63,76,13
245554,1622,343,63,71,8
240434,1570,333,63,68,5
199730,1073,348,63,63,0
193073,1330,281,63,63,0
237355,1583,344,63,63,0
235051,1533,338,63,71,8
255018,1526,330,63,71,8
262433,1556,329,63,70,7
239651,1118,348,63,69,6
238627,1531,331,63,70,7
236579,1398,303,63,65,2
221475,1777,376,63,63,0
213283,1108,361,63,63,0
257058,1658,347,63,63,0
189217,1843,393,63,63,0
247073,1581,348,63,73,10
237601,1618,356,63,70,7
234785,1696,369,63,66,3
251680,1688,363,63,66,3
264228,1527,333,63,78,15
215584,1694,365,63,63,0
260895,1520,324,63,81,18
190239,1613,362,63,63,0
250911,1542,345,63,63,0
239903,1491,321,63,69,6
212511,1591,350,63,63,0
244254,1541,341,63,67,4
207902,1651,349,63,63,0
207646,1668,356,63,65,2
202526,1661,347,63,63,0
263204,921,345,63,67,4
233508,1556,343,63,65,2
188970,1719,360,63,63,0
262183,1641,345,63,68,5
247338,1667,363,63,64,1
244522,1627,341,63,68,5
252201,1657,347,63,75,12
240681,900,331,63,71,8
227881,1677,365,63,68,5
251688,1494,331,63,78,15
241960,1562,344,63,71,8
200744,1772,377,63,63,0
248871,1667,351,63,73,10
241191,1525,338,63,66,3
252710,1643,354,63,68,5
244772,1515,324,63,68,5
246310,1668,362,63,74,11
241958,1638,349,63,70,7
230694,1037,363,63,66,3
211238,1828,388,63,64,1
254757,1420,310,63,63,0
202533,1753,370,63,63,0
258596,1628,339,63,68,5
257316,1392,310,63,69,6
255012,1463,333,63,69,6
260323,1002,341,63,64,1
238694,1598,346,63,63,0
228454,1549,341,63,66,3
209975,1770,382,63,63,0
236143,1506,307,63,63,0
222582,1479,318,63,63,0
232822,1714,383,63,68,5
234614,1516,327,63,72,9
260214,1762,377,63,68,5
222583,1750,373,63,68,5
232567,1379,287,63,63,0
236663,1090,353,63,74,11
226424,1611,342,63,63,0
228216,1641,349,63,63,0
240248,1635,360,63,72,9
242040,1698,368,63,72,9
244088,1620,351,63,70,7
186488,1033,345,63,63,0
255352,1707,357,63,77,14
258936,851,342,63,73,10
216322,1589,341,63,63,0
260354,1416,318,63,68,5
261378,1619,346,63,70,7
264451,1495,325,63,73,10
221443,1661,354,63,63,0
242947,1539,349,63,75,12
251651,1519,325,63,78,15
260611,1572,334,63,63,0
209526,1729,361,63,64,1
264566,1749,371,63,67,4
254069,1670,359,63,71,8
261233,1418,307,63,78,15
260207,1683,363,63,64,1
260719,1468,325,63,63,0
29552,1628,317,63,63,0
230000,1072,352,63,72,9
240496,1473,312,63,76,13
251760,1301,281,63,68,5
257136,1633,365,63,68,5
263281,1424,314,63,79,16
218737,1679,356,63,63,0
259697,1345,291,63,63,0
264050,1594,348,63,76,13
11381,1069,346,63,63,0
228210,1333,299,63,63,0
264307,1478,312,63,75,12
220531,1502,310,63,65,2
242291,1523,335,63,64,1
262260,1709,359,63,74,11
235380,1825,391,63,69,6
237428,1624,362,63,64,1
242292,1506,322,63,68,5
253556,1508,323,63,79,16
258932,1497,329,63,84,21
262404,1411,308,63,73,10
235780,1417,288,63,73,10
240388,1450,317,63,72,9
200718,1342,285,63,66,3
244233,1465,317,63,66,3
254217,1657,366,63,63,0
262154,1539,339,63,75,12
215562,1654,346,63,63,0
228106,1379,295,63,69,6
173836,1692,355,63,63,0
224525,1659,353,63,65,2
238093,1095,350,63,71,8
247309,1568,333,63,68,5
256525,1573,333,63,74,11
205582,1777,377,63,63,0
229641,1550,340,63,63,0
240398,1723,367,63,70,7
186126,1773,356,63,63,0
258574,1562,342,63,67,4
263183,1534,321,63,64,1
264463,1468,311,63,66,3
214287,1447,313,63,64,1
227599,1532,327,63,68,5
236047,1570,338,63,63,0
260367,1551,329,63,64,1
262160,1423,317,63,65,2
236553,1577,344,63,67,4
225545,1759,372,63,68,5
245252,1437,314,63,72,9
225542,1732,353,63,65,2
251908,1673,362,63,73,10
186884,1653,361,63,63,0
254724,1479,316,63,69,6
260100,1644,360,63,80,17
262149,1682,364,63,76,13
200197,1615,333,63,63,0
209413,1510,324,63,63,0
186117,1780,373,63,63,0
260357,1539,318,63,68,5
206598,1712,362,63,63,0
229382,1493,329,63,63,0
224777,1528,330,63,67,4
165894,1480,297,63,63,0
238598,1530,347,63,63,0
262663,1476,320,63,75,12
230919,1523,339,63,69,6
238599,1691,364,63,63,0
239879,1576,346,63,71,8
260359,1520,327,63,67,4
240904,1548,335,63,73,10
242184,1614,346,63,74,11
251400,1542,345,63,68,5
250991,1764,378,63,67,4
217199,1360,297,63,66,3
200294,1731,369,63,63,0
252526,1626,347,63,80,17
238106,1705,377,63,63,0
203034,1143,369,63,63,0
263194,1619,337,63,80,17
246297,1643,363,63,70,7
240665,1474,321,63,65,2
235545,998,346,63,69,6
228889,1552,337,63,64,1
264473,1569,341,63,68,5
262681,1539,338,63,66,3
262425,1666,353,63,66,3
258328,912,345,63,68,5
257304,881,354,63,68,5
256024,1453,325,63,67,4
189208,1562,343,63,63,0
251672,1520,325,63,66,3
238360,1536,345,63,67,4
235800,1526,339,63,70,7
242967,1626,347,63,75,12
261654,1581,349,63,81,18
261398,1446,308,63,63,0
257814,1501,321,63,63,0
256022,1592,338,63,69,6
252438,1709,364,63,75,12
259170,1537,323,63,83,20
264291,1537,328,63,73,10
231267,1595,342,63,69,6
257636,1490,324,63,75,12
263014,1601,349,63,77,14
260197,1174,382,63,63,0
259685,1488,327,63,63,0
258917,1611,347,63,72,9
258149,1538,326,63,70,7
253541,1658,371,63,68,5
250725,1501,329,63,76,13
213093,1711,358,63,63,0
208229,1645,364,63,63,0
202341,1652,350,63,63,0
256868,1700,355,63,63,0
182883,1669,354,63,63,0
255588,1696,376,63,73,10
254820,1540,333,63,76,13
245092,1629,351,63,73,10
236388,1491,330,63,70,7
225636,1556,335,63,68,5
219492,1742,370,63,64,1
218212,1158,361,63,67,4
207460,1798,372,63,63,0
259171,1569,332,63,75,12
192611,1681,361,63,63,0
244758,1419,297,63,72,9
242710,1501,331,63,76,13
240150,1500,333,63,72,9
239468,1583,328,63,66,3
231185,1487,325,63,72,9
213009,1707,361,63,64,1
255760,1589,353,63,73,10
228368,1710,367,63,68,5
223760,1111,343,63,66,3
264464,1675,359,63,72,9
262672,1549,327,63,76,13
200812,1698,365,63,63,0
227948,1428,311,63,66,3
238188,1761,376,63,72,9
244076,1601,349,63,70,7
260369,1670,359,63,75,12
245612,1563,339,63,63,0
247404,1621,356,63,73,10
251500,1715,380,63,63,0
262765,1380,302,63,63,0
213869,1605,340,63,63,0
228461,1608,348,63,64,1
238189,1661,357,63,75,12
242541,1568,336,63,70,7
258925,1612,350,63,76,13
262766,1423,312,63,65,2
242449,1586,349,63,70,7
261137,1674,353,63,64,1
236310,1675,362,63,68,5
231956,1671,364,63,65,2
183829,1719,356,63,63,0
242197,1555,338,63,71,8
240405,1566,329,63,69,6
230677,1399,306,63,66,3
225557,1604,344,63,70,7
223253,1463,316,63,67,4
260372,1612,349,63,66,3
255252,1581,355,63,69,6
243220,1565,339,63,72,9
239636,1667,358,63,63,0
200980,1751,362,63,63,0
205586,1591,347,63,63,0
254483,1488,316,63,71,8
184851,1059,335,63,63,0
227603,1636,356,63,67,4
196883,1478,322,63,63,0
258834,1505,324,63,81,18
187154,1252,278,63,63,0
252434,1643,369,63,66,3
251666,1770,359,63,63,0
181010,1676,341,63,63,0
231954,1704,363,63,65,2
203575,1654,356,63,63,0
254244,1626,349,63,77,14
212535,1474,327,63,64,1
192923,1409,299,63,63,0
257434,1719,366,63,68,5
246682,1467,317,63,82,19
243610,992,333,63,70,7
237978,1512,332,63,72,9
233114,1765,379,63,68,5
226714,1498,331,63,63,0
245145,1540,342,63,70,7
246936,1615,345,63,63,0
211607,1767,371,63,66,3
182422,1137,372,63,63,0
244118,1523,324,63,63,0
200086,1749,368,63,63,0
243349,1684,354,63,78,15
238997,946,334,63,74,11
234645,1552,341,63,64,1
252827,1508,327,63,70,7
260251,1437,308,63,63,0
243871,1713,359,63,76,13
260508,1739,372,63,63,0
241311,1559,326,63,63,0
237983,1423,314,63,73,10
233375,1683,361,63,70,7
213663,1591,350,63,67,4
213151,1714,366,63,66,3
247966,1608,349,63,69,6
245406,1543,352,63,70,7
244126,1451,328,63,73,10
231582,1675,362,63,68,5
223902,1752,358,63,63,0
219550,1485,328,63,63,0
216478,1181,363,63,67,4
263326,1598,356,63,79,16
235421,982,344,63,70,7
209565,1645,350,63,63,0
229269,1784,368,63,66,3
221845,1142,357,63,64,1
216981,1635,355,63,66,3
263573,1466,330,63,76,13
198841,1407,316,63,63,0
198073,1411,304,63,63,0
258488,1579,352,63,63,0
122040,1604,325,63,63,0
251320,1363,310,63,65,2
245176,871,341,63,75,12
244920,1600,356,63,74,11
206520,1649,347,63,63,0
257975,1580,348,63,77,14
257719,1575,327,63,76,13
243639,1511,329,63,71,8
235703,1739,374,63,69,6
232375,1705,345,63,63,0
213687,1616,353,63,63,0
254390,1160,360,63,66,3
221369,1543,332,63,63,0
239801,1603,356,63,71,8
251065,1357,279,63,63,0
208316,1770,366,63,63,0
256404,1436,291,63,72,9
241812,1440,318,63,72,9
260284,1630,350,63,67,4
245436,1595,347,63,65,2
224188,1605,352,63,63,0
211900,1442,302,63,63,0
260027,1404,312,63,72,9
252857,1403,320,63,72,9
256699,1096,348,63,67,4
252858,1656,352,63,76,13
251834,1712,363,63,78,15
240826,1723,367,63,73,10
213434,1749,378,63,64,1
256953,994,349,63,80,17
241567,1416,300,63,74,11
262817,1705,364,63,63,0
163254,1435,303,63,63,0
246744,1365,279,63,70,7
255192,1466,302,63,65,2
256984,1483,325,63,74,11
264665,1686,356,63,73,10
244953,1663,347,63,64,1
182489,1065,337,63,63,0
248025,1017,338,63,63,0
260569,1414,312,63,74,11
262618,1569,334,63,63,0
225498,1703,371,63,68,5
240346,1174,349,63,70,7
255194,1554,347,63,64,1
260826,1532,329,63,73,10
263643,1674,361,63,70,7
205019,1688,366,63,63,0
216795,1565,342,63,66,3
248024,994,354,63,63,0
210392,1726,371,63,66,3
211105,1025,347,63,65,2
209368,1722,366,63,64,1
247970,1772,378,63,63,0
252066,1757,377,63,74,11
255138,1520,325,63,63,0
256418,1669,355,63,77,14
260770,1618,348,63,73,10
237475,1689,361,63,72,9
240803,1595,346,63,70,7
243926,1575,351,63,63,0
256214,1476,316,63,75,12
216023,1560,324,63,63,0
233175,1736,381,63,66,3
252119,1410,314,63,68,5
254935,945,332,63,69,6
255703,1686,359,63,74,11
262103,1578,344,63,71,8
243163,1599,350,63,74,11
186331,1738,357,63,63,0
240605,1770,376,63,74,11
192989,1793,374,63,63,0
237026,1605,343,63,70,7
239586,1309,290,63,65,2
253922,1562,334,63,63,0
258786,1485,322,63,72,9
264419,1486,317,63,66,3
214755,1681,357,63,63,0
222947,1441,309,63,63,0
242594,1700,359,63,69,6
223650,1657,350,63,68,5
211618,1666,352,63,63,0
261025,1502,317,63,86,23
190625,1717,357,63,63,0
253089,1505,333,63,77,14
236193,1689,347,63,63,0
220833,1065,354,63,69,6
262113,1623,344,63,77,14
258273,1698,372,63,72,9
192481,1598,349,63,63,0
260318,1649,347,63,63,0
206558,1788,382,63,63,0
224055,1611,356,63,63,0
240606,1651,349,63,77,14
255454,1686,366,63,69,6
256478,1471,318,63,68,5
259806,1688,358,63,79,16
264159,1565,340,63,75,12
232161,1696,363,63,64,1
218591,1670,357,63,65,2
229087,1562,347,63,68,5
232671,1663,362,63,69,6
235744,1648,366,63,72,9
244192,1433,326,63,68,5
202465,1823,382,63,63,0
252598,1639,345,63,73,10
242328,1654,364,63,77,14
213686,1609,348,63,66,3
246611,1547,328,63,74,11
184148,1069,350,63,64,1
242004,1506,328,63,69,6
203092,1638,368,63,63,0
262484,1479,314,63,63,0
259923,1562,345,63,70,7
191827,1183,371,63,63,0
182867,1582,339,63,63,0
237139,1615,349,63,76,13
205393,1554,342,63,65,2
259154,1481,313,63,64,1
258386,1465,314,63,68,5
257874,1564,336,63,63,0
258485,983,364,63,79,16
257618,1048,353,63,66,3
253778,1576,340,63,63,0
183122,1614,342,63,63,0
238792,1687,363,63,69,6
257992,980,337,63,75,12
165321,1739,360,63,63,0
230982,1564,334,63,63,0
198604,1774,374,63,63,0
258763,926,337,63,77,14
253899,1688,355,63,63,0
240587,1667,352,63,64,1
233931,1416,305,63,70,7
228299,1735,364,63,65,2
242758,1640,355,63,67,4
246986,1519,321,63,72,9
212682,1730,369,63,68,5
263370,1542,324,63,83,20
240329,1604,349,63,72,9
239305,1720,376,63,70,7
246085,1322,284,63,64,1
262726,1628,348,63,68,5
221766,1719,366,63,67,4
240209,1661,357,63,69,6
262481,1769,375,63,63,0
160204,1480,309,63,63,0
223305,1606,342,63,66,3
203338,1645,351,63,63,0
199498,1724,366,63,63,0
262730,1725,376,63,63,0
243785,1583,350,63,74,11
241993,1468,328,63,68,5
240457,1388,295,63,71,8
227913,1466,313,63,70,7
210249,1745,369,63,63,0
241488,1620,346,63,73,10
193608,1813,385,63,63,0
262984,1644,360,63,71,8
257863,1397,303,63,65,2
240967,1549,344,63,72,9
173895,1181,362,63,63,0
263239,1510,329,63,78,15
261446,1725,370,63,77,14
210762,1496,326,63,65,2
229194,1654,357,63,72,9
231498,1494,327,63,65,2
211019,1652,351,63,63,0
235600,1556,334,63,63,0
212560,1091,347,63,65,2
263504,1690,368,63,73,10
243023,1566,335,63,74,11
234063,1482,329,63,69,6
205903,1757,364,63,63,0
260942,1615,348,63,83,20
239182,1483,328,63,64,1
259405,1472,318,63,78,15
183885,1815,367,63,63,0
210509,1089,356,63,63,0
262477,1646,361,63,74,11
254284,1635,362,63,66,3
205388,1742,367,63,63,0
213835,1728,380,63,64,1
215756,1660,352,63,65,2
261322,973,338,63,63,0
228044,1771,370,63,66,3
238036,1695,361,63,72,9
254129,1610,344,63,76,13
224433,1529,327,63,65,2
263089,1667,350,63,71,8
232918,1392,300,63,63,0
262100,1419,326,63,71,8
257236,1432,316,63,68,5
255956,1362,295,63,66,3
247764,1615,343,63,75,12
208852,1740,371,63,63,0
144050,1634,329,63,63,0
241619,1685,363,63,68,5
226259,1101,361,63,63,0
244690,1526,328,63,74,11
243922,1758,384,63,63,0
243154,1528,345,63,77,14
233938,1733,368,63,73,10
253388,1395,300,63,70,7
226514,1636,352,63,69,6
260529,1477,312,63,69,6
212146,1564,339,63,63,0
187857,1228,356,63,63,0
263349,1658,359,63,68,5
191669,1826,371,63,63,0
246965,1492,333,63,68,5
245685,1643,359,63,68,5
242101,1579,339,63,68,5
234421,1477,311,63,68,5
232885,1659,344,63,67,4
216501,1599,329,63,64,1
204725,1099,369,63,64,1
260276,1455,315,63,74,11
221106,1773,381,63,63,0
206004,1351,290,63,63,0
182451,1010,343,63,63,0
247731,1683,360,63,77,14
241075,1681,358,63,70,7
209075,1678,363,63,63,0
253874,1558,342,63,69,6
248498,1505,328,63,79,16
230834,1534,330,63,67,4
255185,1624,349,63,72,9
228562,1124,356,63,67,4
199121,1693,360,63,63,0
162512,1403,298,63,63,0
226509,1823,383,63,64,1
232909,1596,330,63,63,0
244685,1509,321,63,68,5
251597,1519,337,63,73,10
263630,1516,326,63,76,13
260814,1583,335,63,77,14
262607,1513,332,63,79,16
212175,1100,355,63,63,0
225999,1665,350,63,66,3
229327,1706,360,63,63,0
258767,1031,359,63,76,13
260303,1708,361,63,66,3
221648,1629,351,63,63,0
218576,1402,295,63,65,2
229072,1516,327,63,63,0
235728,1436,315,63,72,9
262353,1487,320,63,69,6
261328,1682,355,63,64,1
254416,1660,354,63,63,0
252112,995,342,63,75,12
237776,961,333,63,63,0
254022,1472,328,63,76,13
230864,1585,355,63,68,5
260048,1467,319,62,73,11
259537,1566,335,62,72,10
225485,1392,307,62,64,2
242893,1513,334,62,72,10
184269,1405,299,62,62,0
251085,1586,348,62,62,0
206286,1607,346,62,62,0
260304,1633,357,62,66,4
236241,888,335,62,63,1
247761,1708,358,62,71,9
252113,1544,339,62,62,0
189905,1729,362,62,62,0
258512,1567,348,62,68,6
251088,1312,279,62,62,0
262352,1461,303,62,65,3
211917,1557,320,62,62,0
227791,1589,348,62,62,0
201935,1515,337,62,62,0
257998,968,330,62,76,14
185038,1023,338,62,62,0
242638,1522,342,62,65,3
208590,1641,348,62,62,0
246991,1458,327,62,73,11
257227,1733,364,62,64,2
261580,1502,323,62,70,8
261324,1487,321,62,70,8
257291,1468,321,62,74,12
260619,1595,345,62,68,6
253452,1643,350,62,82,20
218381,1628,343,62,66,4
235277,1461,317,62,67,5
236557,1574,349,62,65,3
243469,1540,324,62,71,9
243981,1290,276,62,72,10
212750,1654,351,62,62,0
224526,1671,350,62,65,3
226830,1749,365,62,67,5
232718,1665,341,62,62,0
237838,1603,346,62,67,5
247755,1444,325,62,68,6
255947,1564,333,62,68,6
239826,1509,341,62,68,6
257995,1544,341,62,70,8
201932,1467,316,62,62,0
223180,1619,351,62,63,1
224204,1039,341,62,70,8
233932,1529,335,62,66,4
239820,1501,334,62,68,6
256460,1543,346,62,76,14
257740,1109,347,62,62,0
193740,1694,358,62,62,0
224466,1674,360,62,63,1
252285,1617,331,62,76,14
251346,1553,334,62,77,15
260050,1445,315,62,80,18
259192,1467,313,62,68,6
205433,1518,328,62,64,2
224889,1619,349,62,62,0
238969,904,332,62,63,1
246137,1529,334,62,76,14
260217,1619,361,62,70,8
234874,1654,352,62,63,1
179578,1389,280,62,62,0
246650,1612,359,62,68,6
247674,1594,349,62,74,12
252794,1630,351,62,77,15
256634,1559,337,62,69,7
211835,1064,354,62,62,0
248443,1671,363,62,78,16
255867,1514,338,62,69,7
257147,1391,305,62,62,0
263947,1577,341,62,77,15
258171,1643,355,62,84,22
264572,1658,353,62,70,8
219260,1075,335,62,64,2
200061,1776,369,62,62,0
207741,1559,330,62,62,0
234365,1708,364,62,71,9
256887,1660,348,62,75,13
224887,1557,336,62,67,5
264567,1713,361,62,77,15
260308,1674,364,62,67,5
260562,1482,320,62,79,17
260818,1403,323,62,68,6
263891,1646,355,62,69,7
205267,1167,364,62,63,1
228307,1662,364,62,67,5
232915,1555,330,62,62,0
237779,1415,303,62,62,0
193235,1682,354,62,62,0
243924,1514,327,62,70,8
246228,1643,354,62,73,11
239317,1526,336,62,69,7
255094,1487,317,62,65,3
212438,1615,354,62,62,0
224470,1795,373,62,64,2
240086,1488,329,62,71,9
241878,1631,340,62,69,7
252277,1722,364,62,70,8
255349,1479,322,62,76,14
214134,1503,326,62,64,2
217718,1334,293,62,65,3
245622,1529,329,62,70,8
252278,1639,345,62,66,4
264459,1627,345,62,71,9
246759,1460,329,62,67,5
262667,1714,361,62,70,8
262628,1560,337,62,67,5
235493,1493,326,62,65,3
244453,1681,344,62,62,0
236006,1788,379,62,65,3
252134,1683,350,62,78,16
194790,1442,300,62,62,0
260326,890,336,62,75,13
261094,1559,342,62,67,5
262118,1651,356,62,78,16
230631,1090,350,62,62,0
251367,1601,349,62,79,17
262119,1379,306,62,73,11
226024,1694,370,62,65,3
231912,1629,353,62,70,8
238568,1508,320,62,64,2
246760,1452,315,62,76,14
257512,1464,315,62,73,11
236009,1528,341,62,72,10
260324,1621,351,62,65,3
195519,1755,375,62,62,0
255721,1610,358,62,69,7
262592,1569,334,62,68,6
251587,1635,349,62,73,11
240323,1695,363,62,70,8
235715,1721,366,62,71,9
262082,1491,319,62,74,12
252866,1419,298,62,76,14
171970,1757,358,62,62,0
237250,1155,363,62,65,3
260033,877,334,62,62,0
251073,1589,344,62,78,16
246465,1636,351,62,75,13
244417,953,340,62,76,14
222145,1726,367,62,64,2
260800,1626,347,62,62,0
258240,1647,358,62,68,6
257728,1621,339,62,62,0
210368,1121,355,62,63,1
264640,1615,340,62,62,0
247017,1550,342,62,68,6
237802,903,335,62,64,2
263620,1565,331,62,85,23
167919,1764,374,62,62,0
264176,1550,334,62,77,15
223984,1685,354,62,67,5
233969,1537,340,62,65,3
183025,1654,359,62,62,0
256753,1637,363,62,75,13
258545,1562,343,62,66,4
262898,1583,334,62,71,9
241138,1482,337,62,70,8
246002,1551,334,62,81,19
244927,1693,363,62,70,8
230847,1566,340,62,70,8
259314,1103,364,62,81,19
234227,1519,334,62,73,11
258547,1531,334,62,66,4
261619,1394,301,62,75,13
262388,1447,304,62,65,3
263156,1606,338,62,69,7
260591,1626,349,62,79,17
221167,1574,344,62,66,4
242154,1664,361,62,71,9
263919,1426,308,62,70,8
243690,1656,361,62,72,10
244202,1499,323,62,62,0
260842,1611,353,62,68,6
210667,1784,367,62,63,1
232427,1446,335,62,65,3
258283,1595,344,62,70,8
260587,981,351,62,74,12
262380,1624,349,62,65,3
205036,1616,347,62,62,0
241388,924,353,62,74,12
191980,1768,370,62,62,0
260076,1593,340,62,72,10
260332,1640,344,62,62,0
232174,1599,342,62,62,0
175598,1748,351,62,62,0
242926,1564,339,62,62,0
262639,1443,315,62,65,3
257731,1542,323,62,62,0
200900,1797,370,62,63,1
256522,1559,336,62,65,3
262918,1678,358,62,70,8
211717,1677,364,62,62,0
255236,946,333,62,74,12
254980,1595,354,62,72,10
237316,1382,289,62,73,11
262148,1573,339,62,71,9
260867,1537,336,62,80,18
260355,1704,360,62,70,8
257027,1179,354,62,70,8
255491,1562,337,62,72,10
260866,1345,285,62,62,0
256770,1639,347,62,73,11
253954,1514,339,62,69,7
253442,909,333,62,73,11
222978,1668,352,62,67,5
262402,1514,319,62,69,7
261377,1461,320,62,75,13
251905,1526,333,62,73,11
251653,1557,333,62,71,9
229126,1555,332,62,62,0
232449,911,323,62,63,1
245510,1593,348,62,67,5
255242,1590,335,62,76,14
228362,1585,343,62,65,3
257289,1505,326,62,79,17
242953,1457,325,62,62,0
237833,1609,347,62,70,8
230921,1632,350,62,67,5
201993,1634,340,62,62,0
260360,1368,294,62,65,3
252424,1502,333,62,71,9
239880,1588,336,62,62,0
222471,1035,338,62,63,1
211463,1711,360,62,62,0
258054,1623,347,62,68,6
257286,1575,349,62,70,8
254726,1583,349,62,62,0
248070,1612,334,62,72,10
245766,1562,346,62,67,5
239873,1492,317,62,65,3
226561,1521,329,62,71,9
220356,1555,330,62,64,2
264392,1641,348,62,71,9
242119,1477,326,62,76,14
240583,1767,378,62,72,10
239559,894,330,62,72,10
169415,1172,362,62,62,0
259014,1725,359,62,67,5
223174,835,331,62,66,4
256453,1516,348,62,76,14
187077,1722,353,62,62,0
251333,1624,361,62,69,7
244677,1606,332,62,74,12
259524,1369,300,62,73,11
191684,1073,349,62,62,0
256964,1532,332,62,77,15
253636,1136,354,62,66,4
253380,1331,277,62,73,11
252868,1478,330,62,75,13
247236,1571,353,62,71,9
259527,1604,345,62,75,13
244680,1585,339,62,68,6
216833,1020,346,62,66,4
251592,1650,351,62,76,14
220375,1699,360,62,63,1
229067,984,342,62,67,5
259530,870,338,62,72,10
259018,1412,308,62,66,4
251082,1736,363,62,62,0
182474,1058,362,62,62,0
242634,1758,366,62,71,9
229066,1656,344,62,65,3
202698,1802,373,62,62,0
255177,1593,341,62,68,6
230345,1601,344,62,62,0
218057,1583,340,62,63,1
208073,1414,310,62,62,0
262345,1517,323,62,62,0
258504,1542,344,62,67,5
255944,1492,320,62,69,7
253384,1507,324,62,73,11
237181,1425,319,62,66,4
231503,1564,344,62,67,5
253821,1460,325,62,72,10
258352,1587,337,62,74,12
264239,1589,340,62,77,15
240175,1642,356,62,73,11
245039,1634,352,62,71,9
259631,1543,323,62,74,12
208944,1425,296,62,62,0
227632,1691,367,62,64,2
186416,1565,333,62,62,0
254768,1487,328,62,62,0
258864,971,337,62,70,8
260910,1573,342,62,84,22
259632,1428,308,62,72,10
260144,1658,351,62,85,23
263217,1561,345,62,74,12
264241,1423,311,62,76,14
202801,1480,325,62,62,0
205361,1710,369,62,62,0
245041,1565,343,62,74,12
258609,1476,318,62,72,10
262959,1593,339,62,63,1
243502,928,332,62,66,4
208457,1614,340,62,62,0
259403,1515,334,62,76,14
257353,1745,378,62,80,18
259401,1619,357,62,79,17
259913,1632,358,62,77,15
263242,1527,337,62,66,4
222282,1641,349,62,62,0
242506,1649,363,62,76,14
246858,1513,341,62,73,11
257611,1559,335,62,72,10
212812,1536,331,62,65,3
242734,1276,272,62,66,4
236364,1681,357,62,68,6
246861,1623,338,62,75,13
231502,1654,356,62,62,0
246862,1647,341,62,66,4
247886,1560,331,62,68,6
259918,930,333,62,65,3
260141,1625,331,62,78,16
233006,1496,336,62,62,0
181298,1447,319,62,62,0
256050,928,319,62,73,11
259634,1504,330,62,73,11
259641,1681,368,62,75,13
240951,1560,346,62,74,12
252471,1662,346,62,71,9
263736,1518,317,62,68,6
264248,1533,337,62,73,11
211512,1586,342,62,62,0
237624,1374,303,62,63,1
258360,1569,339,62,68,6
208697,1071,360,62,64,2
260409,942,338,62,78,16
262963,1597,346,62,62,0
261689,1563,339,62,77,15
247822,1667,343,62,73,11
213519,1757,375,62,67,5
179871,1708,346,62,62,0
263839,1567,338,62,67,5
248478,911,342,62,77,15
240286,933,338,62,72,10
261533,1595,343,62,74,12
210999,1371,292,62,62,0
258870,1599,341,62,74,12
190518,1703,363,62,62,0
252470,1580,337,62,76,14
253491,1608,348,62,72,10
256051,1621,347,62,74,12
258867,1520,336,62,72,10
201268,1634,356,62,62,0
224820,1583,331,62,65,3
256564,1491,337,62,78,16
262709,1404,294,62,71,9
202549,1448,304,62,65,3
235573,1531,340,62,64,2
244533,1646,350,62,66,4
247093,1665,354,62,74,12
256053,936,330,62,75,13
258869,1457,302,62,62,0
260149,1671,362,62,75,13
261173,934,336,62,68,6
236342,1560,345,62,62,0
242230,1627,340,62,68,6
224585,1510,319,62,62,0
261704,1577,339,62,72,10
239742,997,340,62,68,6
263250,1554,334,62,75,13
189013,1084,346,62,62,0
236885,1478,317,62,68,6
245076,1358,302,62,71,9
243284,1458,320,62,72,10
214099,1785,381,62,64,2
254290,1586,344,62,79,17
253010,1632,346,62,77,15
236626,1535,338,62,65,3
257873,1591,341,62,62,0
252758,1631,346,62,79,17
243537,1466,323,62,72,10
240977,1595,357,62,69,7
225361,1050,347,62,66,4
214353,1062,353,62,65,3
260432,1602,351,62,68,6
230736,1530,334,62,69,7
221264,1632,358,62,63,1
258895,1518,328,62,75,13
262742,898,332,62,68,6
256854,1458,311,62,73,11
238920,1603,346,62,65,3
263515,1547,331,62,78,16
260444,1358,295,62,65,3
258396,1431,314,62,75,13
235868,1509,331,62,67,5
233052,1593,346,62,73,11
222300,1603,347,62,63,1
258139,1447,311,62,80,18
252507,1664,359,62,75,13
264539,1545,335,62,62,0
252506,1660,358,62,77,15
262487,1712,358,62,66,4
251482,1529,335,62,72,10
243034,1559,340,62,73,11
263258,1389,304,62,65,3
255065,1453,316,62,71,9
225881,1503,319,62,62,0
170072,1615,350,62,62,0
259671,1516,329,62,75,13
255063,1492,316,62,65,3
253775,1711,360,62,66,4
246863,1654,355,62,78,16
234831,1659,360,62,65,3
236611,1556,334,62,68,6
238913,1578,336,62,62,0
262978,1559,338,62,71,9
264258,1664,360,62,62,0
222274,1023,342,62,62,0
257090,1388,300,62,76,14
260930,1404,295,62,74,12
261442,1494,326,62,74,12
216387,1489,334,62,62,0
264260,1584,340,62,80,18
53818,1717,349,62,62,0
259908,1459,320,62,67,5
264006,1437,306,62,69,7
205382,1574,347,62,62,0
212038,1154,354,62,63,1
237382,1649,339,62,73,11
257350,940,330,62,69,7
239175,1664,359,62,69,7
260167,1415,296,62,75,13
170305,1662,329,62,62,0
235329,1633,345,62,69,7
233793,1609,347,62,68,6
204097,1578,345,62,62,0
232507,946,334,62,62,0
252219,1539,332,62,77,15
263228,1542,333,62,73,11
225084,1605,345,62,65,3
210493,1715,362,62,62,0
188989,1679,363,62,62,0
260925,1689,367,62,72,10
229182,1361,290,62,70,8
241214,1446,322,62,69,7
244542,1695,349,62,69,7
246078,1544,336,62,73,11
239423,1574,330,62,62,0
246591,1594,343,62,69,7
261439,1480,323,62,69,7
232256,1606,348,62,63,1
240704,1331,352,62,69,7
245056,872,332,62,66,4
255389,923,330,62,70,8
253597,1360,298,62,62,0
251293,1573,339,62,73,11
245153,1389,311,62,80,18
191006,1394,302,62,62,0
247967,1558,333,62,62,0
251807,1445,312,62,69,7
258975,1508,327,62,72,10
203424,1819,383,62,63,1
262305,1003,342,62,71,9
222625,1414,299,62,65,3
177313,1563,327,62,62,0
252321,1609,353,62,74,12
262942,1700,368,62,70,8
255393,1478,322,62,68,6
234658,1063,343,62,70,8
242850,1499,324,62,75,13
250786,1553,340,62,75,13
251042,1758,375,62,63,1
258722,1455,312,62,75,13
263075,1695,371,62,66,4
238755,1520,337,62,69,7
155422,1011,338,62,62,0
257309,1525,326,62,72,10
243869,1458,320,62,72,10
257051,1635,355,62,76,14
247833,1513,332,62,74,12
252697,1449,317,62,75,13
258841,1567,347,62,79,17
232474,1638,343,62,69,7
183066,1428,308,62,62,0
248858,870,336,62,74,12
200731,1381,290,62,62,0
190235,1573,339,62,62,0
264220,1530,332,62,75,13
251165,987,341,62,68,6
220956,1458,326,62,66,4
235548,1569,344,62,62,0
239644,1440,311,62,69,7
177692,1810,384,62,62,0
259612,1576,353,62,76,14
227869,1714,368,62,67,5
228637,1524,319,62,66,4
246557,1536,337,62,62,0
259235,1525,335,62,72,10
263332,1674,347,62,70,8
202660,1589,350,62,62,0
211884,1692,365,62,62,0
262314,1615,357,62,71,9
263082,1518,329,62,68,6
246442,1513,336,62,63,1
253098,1667,361,62,70,8
256170,1642,345,62,72,10
236459,1583,346,62,62,0
251051,1649,341,62,62,0
263084,1365,298,62,69,7
231852,1604,343,62,62,0
209572,1156,341,62,62,0
234412,1548,342,62,63,1
238508,1399,303,62,72,10
244140,1598,344,62,76,14
246956,1477,324,62,74,12
254636,1601,356,62,69,7
260268,1461,311,62,62,0
207789,1720,357,62,62,0
213677,1102,351,62,68,6
255913,1653,354,62,73,11
255145,1671,364,62,71,9
243881,1673,361,62,63,1
254120,1714,364,62,81,19
226724,1581,346,62,67,5
237220,1612,352,62,64,2
248740,1543,329,62,74,12
262821,1664,359,62,70,8
224677,1717,356,62,62,0
242085,1716,363,62,68,6
253861,1605,348,62,62,0
259237,1532,322,62,77,15
246950,1465,304,62,78,16
259750,1500,331,62,79,17
263079,1493,324,62,67,5
233383,1369,311,62,74,12
250791,1566,328,62,74,12
253095,1600,349,62,78,16
183720,1736,364,62,62,0
251048,1477,325,62,67,5
251816,1589,337,62,74,12
235288,1587,334,62,73,11
246807,1345,292,62,69,7
243223,1637,358,62,73,11
240791,950,334,62,67,5
182681,1737,375,62,62,0
211353,1162,352,62,66,4
248216,886,325,62,73,11
246680,1665,361,62,67,5
242584,1676,359,62,64,2
211864,1645,357,62,62,0
207768,1570,325,62,62,0
203416,1579,335,62,62,0
213143,1610,351,62,64,2
240788,1482,331,62,73,11
203415,1762,376,62,62,0
262295,1010,352,62,68,6
240278,1489,329,62,72,10
255125,1630,346,62,75,13
213653,1356,296,62,67,5
263829,1480,314,62,72,10
260244,1551,321,62,67,5
253332,1555,347,62,68,6
257177,1644,342,62,71,9
264090,1535,331,62,66,4
203930,1535,340,62,62,0
222618,1714,366,62,62,0
240285,1619,347,62,70,8
236445,1411,313,62,69,7
254876,965,341,62,67,5
251548,1682,361,62,76,14
230812,1743,370,62,68,6
221852,1522,330,62,62,0
208540,1542,334,62,62,0
264092,1526,330,62,79,17
262812,967,330,62,62,0
259995,1534,337,62,68,6
185243,1490,319,62,62,0
244891,1408,304,62,68,6
165787,1770,372,62,62,0
261018,955,329,62,65,3
257946,1415,302,62,70,8
251034,922,325,62,65,3
239258,1742,357,62,68,6
187796,1663,348,62,62,0
240532,1568,351,62,71,9
239383,1440,308,62,62,0
234261,1403,310,62,69,7
259858,1559,325,62,74,12
242707,1309,283,62,64,2
263188,1701,353,62,75,13
263956,1619,348,62,67,5
232212,1692,359,62,69,7
261140,1555,343,62,69,7
262933,1570,339,62,72,10
263189,1707,353,62,67,5
246549,1552,333,62,69,7
232596,1434,312,62,62,0
210966,1588,346,62,62,0
229398,1620,338,62,66,4
231446,1687,361,62,71,9
248086,1567,338,62,68,6
253974,1674,359,62,77,15
262935,1735,369,62,69,7
263703,1618,350,62,78,16
172823,1661,341,62,62,0
256018,1494,327,62,68,6
202770,1012,338,62,64,2
263954,1617,343,62,77,15
262674,1505,316,62,73,11
221844,1098,338,62,62,0
221332,1071,349,62,66,4
255635,1565,330,62,76,14
186259,1586,330,62,62,0
184467,1584,339,62,62,0
113555,1600,340,62,62,0
10899,1588,323,62,62,0
262547,1390,306,62,67,5
229135,1031,345,62,68,6
233743,1596,344,62,70,8
251151,1481,314,62,76,14
256527,1405,303,62,68,6
258319,1547,330,62,77,15
219664,1485,324,62,62,0
245008,1627,353,62,67,5
263953,1491,325,62,82,20
228113,1480,317,62,69,7
262237,1445,311,62,75,13
200286,1591,345,62,62,0
202079,1024,328,62,64,2
212106,1617,355,62,63,1
242060,1564,342,62,62,0
207756,1711,354,62,65,3
255115,1439,308,62,74,12
264587,1424,307,62,75,13
263307,1491,328,62,69,7
255114,1605,335,62,73,11
247946,1309,281,62,65,3
213642,1591,335,62,65,3
258441,1405,297,62,72,10
254348,1370,293,62,67,5
169609,1606,338,62,62,0
232585,1701,375,62,62,0
220041,1575,339,62,65,3
203145,1506,320,62,63,1
201353,1096,367,62,63,1
261768,1525,330,62,73,11
152456,1104,357,62,62,0
262792,1568,352,62,73,11
244108,1756,366,62,69,7
259212,1570,345,62,74,12
245286,1523,325,62,76,14
255119,1538,331,62,63,1
241809,1649,364,62,73,11
234897,1644,352,62,65,3
211345,1536,337,62,66,4
245648,1486,321,62,74,12
239504,1795,384,62,63,1
230032,1593,369,62,66,4
222864,1042,349,62,66,4
222096,1057,337,62,71,9
245903,1775,366,62,79,17
239245,1503,339,62,64,2
234639,1389,297,62,67,5
222351,1793,369,62,62,0
222095,1089,352,62,65,3
198543,1642,362,62,62,0
241038,1635,352,62,70,8
236686,1621,359,62,67,5
245901,1504,329,62,79,17
239501,1738,367,62,69,7
258183,924,337,62,72,10
241543,1614,344,62,74,12
235143,1549,343,62,67,5
210986,1681,352,62,65,3
192811,1777,366,62,62,0
257067,1549,342,62,69,7
252715,1533,337,62,66,4
242731,1392,309,62,71,9
170027,1313,277,62,62,0
229163,1680,375,62,74,12
232746,1464,322,62,64,2
215338,1795,382,62,62,0
262954,1501,325,62,83,21
247942,1677,345,62,62,0
251689,1391,306,62,77,15
246825,1519,335,62,72,10
239401,1468,316,62,70,8
239145,1691,355,62,69,7
236585,1659,353,62,68,6
202793,1124,353,62,62,0
260392,1534,345,62,66,4
254760,904,328,62,69,7
197932,1629,355,62,62,0
233772,1609,342,62,63,1
244780,1571,339,62,67,5
257068,1658,364,62,74,12
245126,1538,341,62,70,8
220038,1479,333,62,66,4
219782,1409,304,62,62,0
211846,1684,359,62,62,0
262021,1412,315,62,64,2
260485,1603,348,62,80,18
254085,871,336,62,67,5
245893,1715,371,62,70,8
240517,1712,358,62,69,7
236677,1355,292,62,74,12
213893,1406,308,62,64,2
261764,1514,324,62,62,0
242564,934,336,62,62,0
237188,959,328,62,76,14
259117,1557,341,62,74,12
186157,1783,374,62,62,0
213805,1689,353,62,63,1
230290,1530,313,62,62,0
231570,1508,332,62,62,0
239477,904,323,62,71,9
254309,1567,344,62,63,1
258691,1512,341,62,74,12
263300,1395,303,62,70,8
210820,1545,339,62,65,3
259683,1315,290,62,73,11
233572,1618,353,62,67,5
238949,1690,358,62,65,3
248165,1694,360,62,71,9
253797,1449,308,62,62,0
258405,1518,330,62,72,10
261223,1520,333,62,70,8
199014,1546,320,62,62,0
210022,1095,359,62,64,2
237926,1452,324,62,68,6
251494,1520,336,62,74,12
224615,1678,358,62,62,0
225383,1756,372,62,68,6
229735,1571,346,62,68,6
245863,1524,333,62,72,10
209027,1087,344,62,62,0
205443,1550,336,62,62,0
263555,1395,294,62,74,12
259714,1571,350,62,77,15
242302,1682,360,62,69,7
251774,1387,299,62,62,0
246911,1600,352,62,64,2
252031,1725,378,62,65,3
210304,1726,359,62,62,0
213376,1706,351,62,66,4
194944,1635,356,62,62,0
261504,1603,346,62,69,7
262529,1548,323,62,71,9
215425,1652,352,62,69,7
183425,1575,338,62,62,0
251521,1651,359,62,75,13
257153,1514,329,62,79,17
263810,1645,352,62,70,8
225922,1763,377,62,67,5
239746,882,326,62,67,5
245122,1581,344,62,76,14
258919,1440,309,62,74,12
260968,1642,365,62,69,7
232053,1551,348,62,68,6
259185,1539,327,62,74,12
169584,1607,327,62,62,0
261488,1624,339,62,72,10
242545,1548,333,62,69,7
177521,1670,337,62,62,0
244081,1581,351,62,66,4
183665,1739,354,62,62,0
252785,1564,337,62,73,11
253553,1570,334,62,72,10
262770,1632,356,62,68,6
205161,1615,345,62,62,0
217202,1587,338,62,63,1
225650,1073,353,62,66,4
237426,1021,337,62,62,0
239730,1665,357,62,63,1
254834,1601,363,62,73,11
220787,1540,339,62,67,5
231284,1390,301,62,68,6
240756,1491,321,62,73,11
234096,1654,352,62,72,10
258415,1654,347,62,69,7
245615,1535,333,62,70,8
260974,1517,347,62,65,3
232553,1572,324,62,62,0
263786,1650,351,62,71,9
238187,1472,324,62,73,11
247403,1350,288,62,62,0
255851,1487,326,62,69,7
260203,1299,282,62,68,6
263020,1490,325,62,65,3
223852,1410,310,62,67,5
234860,1807,387,62,69,7
243052,1583,350,62,65,3
252524,1479,323,62,70,8
260716,1454,320,62,68,6
262509,1655,343,62,72,10
237933,1561,337,62,71,9
261485,1594,343,62,63,1
150894,1573,314,62,62,0
251502,1554,334,62,71,9
255527,1692,361,62,67,5
210726,1552,348,62,63,1
210783,1507,333,62,62,0
263903,1491,320,62,66,4
258784,1609,346,62,71,9
257248,1713,360,62,75,13
207584,1547,333,62,62,0
200928,1804,372,62,62,0
259807,1361,292,62,73,11
192479,1742,369,62,62,0
251359,1434,310,62,64,2
242399,1716,366,62,69,7
260574,1613,343,62,76,14
202977,1695,351,62,62,0
259038,1535,344,62,71,9
257246,1572,346,62,79,17
253662,1690,361,62,70,8
251870,1460,328,62,72,10
251358,1609,339,62,65,3
243422,1525,332,62,65,3
238046,1558,342,62,67,5
262109,1498,326,62,82,20
264161,889,336,62,71,9
243169,1531,330,62,76,14
258085,947,336,62,70,8
254638,1694,367,62,75,13
204722,1692,356,62,62,0
252080,1579,334,62,70,8
262320,1631,342,62,74,12
237999,1692,362,62,63,1
223407,1111,351,62,62,0
263343,1593,337,62,74,12
259758,1686,358,62,74,12
255150,1569,355,62,78,16
263342,1357,288,62,72,10
255457,1491,322,62,72,10
169389,1681,337,62,62,0
190179,1054,347,62,62,0
250851,1356,301,62,74,12
238051,1563,336,62,68,6
239074,1543,329,62,71,9
232674,1464,327,62,63,1
212450,1554,330,62,62,0
205026,1690,365,62,62,0
255453,1462,313,62,72,10
254685,1584,340,62,73,11
254173,1560,333,62,73,11
232291,1645,348,62,62,0
240600,1708,373,62,67,5
227288,1812,373,62,67,5
260311,1353,287,62,67,5
258519,1681,357,62,68,6
256983,1276,283,62,70,8
226775,1728,364,62,62,0
238179,1353,304,62,71,9
237923,1538,329,62,69,7
222051,1443,313,62,63,1
245981,1627,354,62,69,7
240738,1636,367,62,62,0
173665,1747,361,62,62,0
232545,1585,335,62,70,8
255072,1447,321,62,75,13
264288,1388,297,62,74,12
253791,999,339,62,72,10
242271,1728,356,62,76,14
228191,1377,307,62,65,3
255449,1621,354,62,73,11
255705,1387,306,62,67,5
263898,1506,329,62,72,10
256218,1637,355,62,68,6
245725,1530,322,62,71,9
234205,1664,367,62,71,9
225245,1609,344,62,65,3
263645,1464,328,62,68,6
260828,1514,328,62,75,13
255452,933,338,62,69,7
181468,1239,369,62,62,0
245212,1484,317,62,71,9
243932,1644,353,62,75,13
238044,1497,336,62,64,2
222172,1773,376,62,62,0
258523,1487,329,62,72,10
256219,1625,341,62,70,8
252379,1652,364,62,76,14
248539,1544,333,62,71,9
240347,1610,356,62,62,0
231131,1734,383,62,69,7
245170,1714,366,62,73,11
260274,986,333,62,69,7
224691,1445,320,62,62,0
212255,1111,355,62,63,1
264481,1483,325,62,70,8
262689,1513,332,62,66,4
190240,1634,339,62,62,0
244256,977,343,62,67,5
264480,1391,296,62,71,9
259615,1661,358,62,75,13
242975,1401,298,62,70,8
236319,1668,354,62,71,9
259614,1437,312,62,71,9
182206,1165,361,62,62,0
200704,1542,334,62,62,0
215808,1569,339,62,63,1
223488,1084,352,62,68,6
233728,1471,318,62,71,9
243200,1629,350,62,79,17
260352,1514,327,62,66,4
264127,1546,339,62,72,10
253118,1615,355,62,73,11
223777,1369,296,62,62,0
228385,1041,344,62,68,6
232481,906,332,62,62,0
236321,1449,313,62,73,11
247333,1504,325,62,77,15
236325,1603,346,62,74,12
232997,1510,334,62,65,3
227877,1731,371,62,66,4
244004,1596,350,62,76,14
242980,1549,339,62,72,10
254243,1577,336,62,80,18
244515,1655,357,62,75,13
243491,1505,333,62,78,16
240675,1527,330,62,71,9
230179,1094,350,62,62,0
263715,1587,335,62,70,8
257570,1583,350,62,70,8
257314,1607,358,62,71,9
245026,1740,375,62,72,10
229922,1726,367,62,68,6
251425,1728,371,62,69,7
248766,892,323,62,70,8
230846,1759,383,62,68,6
242611,1605,347,62,71,9
263094,1510,341,62,67,5
229303,1565,328,62,67,5
226743,1596,321,62,62,0
261558,1669,357,62,70,8
256950,1433,314,62,62,0
256694,1527,343,62,67,5
255414,1569,340,62,68,6
243126,1564,342,62,65,3
240054,1634,344,62,62,0
262838,1460,331,62,68,6
207806,1815,384,62,62,0
251317,1515,330,62,74,12
183477,1069,342,62,62,0
169909,1730,367,62,62,0
230068,1545,337,62,72,10
199860,1594,342,62,62,0
264116,1041,357,62,81,19
258227,1493,319,62,76,14
256691,1531,336,62,63,1
259767,1430,327,62,72,10
262840,1653,368,62,68,6
225976,1531,332,62,63,1
242104,1693,367,62,62,0
204222,1773,367,62,62,0
264126,1566,334,62,70,8
261565,1376,311,62,68,6
247741,1611,350,62,70,8
242109,1532,337,62,72,10
211389,1590,329,62,62,0
258492,994,333,62,77,15
256700,1511,322,62,71,9
242364,1682,375,62,78,16
173244,1138,348,62,62,0
264380,1591,345,62,77,15
183993,1784,367,62,62,0
244409,953,327,62,62,0
238009,1707,372,62,67,5
221625,1513,318,62,62,0
200633,1423,314,62,62,0
243896,1584,330,62,62,0
241422,1617,343,62,74,12
212989,1675,351,62,62,0
214783,1512,316,62,62,0
258815,1651,348,62,73,11
234490,1698,363,62,64,2
233466,897,329,62,73,11
264442,1362,295,62,68,6
262906,1632,351,62,74,12
257785,1635,349,62,73,11
243705,1584,322,62,71,9
229881,1585,338,62,62,0
260600,1564,338,62,74,12
247032,1483,320,62,63,1
165880,1701,348,62,62,0
200952,1728,366,62,62,0
248823,1660,352,62,70,8
243959,1617,352,62,72,10
262647,1582,344,62,73,11
245494,1582,341,62,69,7
240886,1465,330,62,68,6
165110,1569,330,62,62,0
262902,1492,328,62,65,3
183807,1579,329,62,62,0
198655,1720,373,62,62,0
170229,1331,288,62,62,0
260094,1550,342,62,63,1
262907,1446,315,62,63,1
263163,1464,327,62,72,10
201467,1280,273,62,62,0
233211,978,339,62,67,5
233467,1585,346,62,62,0
242683,1539,332,62,74,12
245499,1409,313,62,67,5
262396,1615,344,62,72,10
207868,1742,376,62,62,0
260092,1560,334,62,70,8
241658,1545,326,62,67,5
163581,1449,303,62,62,0
231933,1541,340,62,62,0
183549,1017,350,62,62,0
253693,1550,329,62,76,14
255485,951,336,62,73,11
259581,1503,326,62,76,14
262654,1102,356,62,70,8
251902,1616,348,62,75,13
261621,1490,328,62,82,20
258804,1399,304,62,75,13
252922,1603,338,62,74,12
223988,1118,350,62,67,5
254964,1523,318,62,76,14
264692,1526,320,62,70,8
255226,1466,322,62,72,10
230644,1708,368,62,67,5
253428,1139,345,62,76,14
232436,1557,345,62,62,0
253161,1404,297,61,68,7
232682,1594,345,61,63,2
248109,1537,328,61,61,0
246829,1571,346,61,64,3
238057,1690,368,61,66,5
237101,1724,375,61,70,9
209965,1543,332,61,61,0
263149,1575,345,61,80,19
258284,1576,334,61,71,10
254188,1601,336,61,70,9
251628,1684,356,61,74,13
254509,1305,296,61,67,6
263404,1507,331,61,77,16
244715,1654,354,61,78,17
223467,1445,315,61,64,3
256746,1574,342,61,75,14
248298,1580,332,61,61,0
222188,1610,347,61,61,0
264238,1564,329,61,77,16
229678,1462,323,61,68,7
242990,1632,351,61,61,0
256819,1605,350,61,74,13
253235,1536,338,61,70,9
248371,1619,350,61,73,12
177971,1467,298,61,61,0
224307,1485,328,61,67,6
248114,1721,367,61,69,8
240946,1540,331,61,68,7
239666,1543,333,61,71,10
199218,1498,315,61,61,0
261169,1535,330,61,70,9
255793,1418,311,61,70,9
254513,986,362,61,66,5
261167,1554,354,61,68,7
260143,1403,310,61,71,10
252975,1619,333,61,76,15
247343,1577,339,61,70,9
237937,1656,361,61,72,11
261352,1605,338,61,70,9
231932,1606,348,61,67,6
204348,1645,346,61,61,0
243004,1315,300,61,67,6
260351,1569,327,61,64,3
258303,1440,311,61,71,10
232959,1597,343,61,61,0
205311,1538,329,61,61,0
262399,1451,309,61,70,9
256510,1403,301,61,75,14
251646,1604,353,61,64,3
213502,1391,294,61,65,4
262910,1503,326,61,67,6
259325,1632,345,61,68,7
230653,1044,339,61,67,6
214525,1007,335,61,64,3
259579,1490,308,61,72,11
258355,1594,347,61,73,12
253179,1535,324,61,71,10
263418,1500,318,61,73,12
255225,1277,267,61,61,0
203512,1575,326,61,61,0
260087,1526,333,61,76,15
251895,1340,297,61,72,11
262903,1431,316,61,68,7
247286,1523,330,61,65,4
207606,1106,342,61,62,1
263158,1535,316,61,67,6
257013,1513,329,61,67,6
241397,1675,365,61,71,10
240373,1662,361,61,75,14
252916,1480,318,61,70,9
261691,1561,327,61,74,13
260923,1516,320,61,75,14
259899,931,323,61,69,8
191803,982,336,61,61,0
263732,1397,311,61,70,9
234804,1476,328,61,71,10
238132,1512,327,61,67,6
204853,1455,316,61,61,0
247349,1563,339,61,77,16
262710,1618,342,61,71,10
264502,1443,320,61,69,8
228918,1513,328,61,64,3
247350,1348,295,61,72,11
254262,1385,314,61,81,20
258102,1693,365,61,68,7
260918,960,331,61,72,11
234295,1705,373,61,66,5
243767,1617,343,61,74,13
258103,1610,350,61,76,15
260919,1570,332,61,70,9
263480,1267,273,61,77,16
251192,1452,318,61,72,11
254776,1388,306,61,68,7
257080,1485,320,61,72,11
264249,1480,328,61,71,10
208953,1616,345,61,61,0
234297,1703,366,61,68,7
240186,1454,328,61,65,4
176442,1756,365,61,61,0
242746,1389,302,61,67,6
256058,1497,322,61,74,13
261690,1421,297,61,77,16
243515,1564,334,61,70,9
262633,1277,288,61,67,6
253921,1483,319,61,63,2
255720,1467,329,61,69,8
248296,1524,330,61,61,0
263435,1462,325,61,82,21
239371,1018,343,61,69,8
243468,1571,340,61,76,15
254989,1347,290,61,69,8
259085,994,331,61,73,12
261133,1566,331,61,80,19
262926,1500,324,61,68,7
251918,1314,281,61,66,5
254222,1507,324,61,70,9
237839,1418,300,61,72,11
251919,1380,308,61,74,13
224016,1640,353,61,62,1
226832,1475,316,61,72,11
254992,1561,338,61,70,9
262673,1490,316,61,71,10
202769,1581,326,61,61,0
229393,1036,355,61,65,4
231697,1483,324,61,72,11
201491,1650,346,61,61,0
233492,1474,327,61,70,9
241428,1501,331,61,67,6
244501,1454,313,61,61,0
263190,1528,323,61,62,1
200714,1579,340,61,62,1
263178,1436,311,61,67,6
248073,1044,341,61,72,11
254469,1561,344,61,66,5
262659,947,339,61,75,14
243971,1496,322,61,68,7
264452,1515,330,61,77,16
202244,1121,355,61,61,0
250884,1433,311,61,69,8
256004,926,333,61,70,9
257796,1032,346,61,61,0
261380,1647,349,61,69,8
252165,1623,350,61,74,13
252421,1522,328,61,71,10
258821,1569,342,61,74,13
169481,1558,327,61,61,0
246278,1604,338,61,75,14
258822,1564,337,61,70,9
220167,1018,344,61,67,6
239623,1624,349,61,66,5
257031,1673,362,61,72,11
262664,1379,299,61,69,8
243464,1652,355,61,64,3
263177,1605,348,61,65,4
215561,1599,341,61,63,2
230409,1519,314,61,61,0
221206,1564,340,61,61,0
239126,1500,330,61,64,3
251926,1632,351,61,80,19
263398,1527,322,61,74,13
232675,1350,299,61,68,7
237027,1524,335,61,67,6
258787,1557,331,61,69,8
222180,1464,327,61,61,0
257764,1521,318,61,68,7
210149,1509,329,61,61,0
232677,1597,339,61,62,1
257253,1402,299,61,76,15
258533,1484,318,61,70,9
261349,1507,316,61,73,12
241382,1528,325,61,77,16
232418,953,326,61,61,0
262940,1422,321,61,77,16
255206,1481,324,61,81,20
256742,997,341,61,71,10
202727,1614,353,61,61,0
209895,1068,344,61,63,2
250855,1481,322,61,72,11
257255,1472,329,61,70,9
200936,1555,348,61,61,0
228072,1618,352,61,61,0
232680,1598,354,61,61,0
259810,1552,331,61,77,16
260577,1631,345,61,80,19
255255,1719,347,61,71,10
257245,1561,342,61,74,13
258071,1447,308,61,72,11
262168,1445,318,61,68,7
263448,1507,323,61,75,14
238104,1598,336,61,61,0
259096,1654,358,61,78,17
261595,1534,331,61,72,11
263132,1461,326,61,73,12
240604,1573,334,61,69,8
242652,1561,332,61,69,8
254172,1415,319,61,74,13
260061,1437,315,61,72,11
262899,1264,294,61,67,6
233950,1622,347,61,65,4
257758,1548,330,61,62,1
263135,1625,342,61,76,15
244191,940,334,61,74,13
260575,1673,353,61,67,6
264160,1624,339,61,69,8
246240,977,335,61,72,11
246752,1500,337,61,73,12
251872,1490,337,61,71,10
233953,1637,351,61,70,9
252148,1679,361,61,75,14
257753,1589,327,61,61,0
257010,922,318,61,68,7
262488,1486,316,61,68,7
229731,1510,329,61,67,6
247395,1441,316,61,73,12
242276,1580,346,61,66,5
250724,1577,339,61,72,11
252260,1538,335,61,68,7
261476,1440,308,61,74,13
263270,1572,329,61,62,1
209254,1723,366,61,61,0
222822,1714,368,61,64,3
207463,1644,353,61,62,1
253799,1372,304,61,66,5
219392,1717,367,61,64,3
190720,1492,325,61,61,0
238081,1395,304,61,69,8
263170,1458,309,61,68,7
238338,1586,346,61,66,5
247042,1372,310,61,70,9
253996,1674,358,61,77,16
185388,1603,328,61,61,0
242732,1595,347,61,77,16
241452,1538,336,61,73,12
236588,1636,357,61,67,6
215084,1649,354,61,61,0
207459,1716,374,61,61,0
264035,1521,321,61,77,16
248674,1577,344,61,77,16
261211,1453,322,61,62,1
240472,1490,322,61,67,6
257112,1439,311,61,69,8
237657,1636,362,61,74,13
240473,1637,334,61,72,11
255577,1430,314,61,70,9
258393,1600,350,61,74,13
264026,1594,342,61,77,16
224602,1595,343,61,61,0
260442,1531,330,61,66,5
259419,1462,310,61,83,22
247388,1460,317,61,80,19
264546,1585,339,61,70,9
221277,1689,353,61,63,2
233054,1683,353,61,61,0
243294,924,331,61,75,14
262751,1255,275,61,67,6
252255,931,326,61,74,13
254303,1645,343,61,70,9
213344,1242,359,61,67,6
247905,1348,289,61,66,5
260705,1494,323,61,67,6
264290,1457,310,61,81,20
263724,1606,337,61,76,15
240939,1590,334,61,70,9
239915,1424,299,61,75,14
264221,1467,326,61,77,16
237089,1541,327,61,62,1
208929,1632,352,61,61,0
241440,1649,366,61,70,9
238880,1323,289,61,68,7
251167,1332,290,61,70,9
193310,1457,299,61,61,0
244510,1566,337,61,71,10
239646,1503,332,61,68,7
244765,1553,325,61,69,8
237341,1374,299,61,70,9
263965,1646,349,61,68,7
256801,1388,290,61,74,13
194076,1591,326,61,61,0
247836,1500,334,61,71,10
245276,1210,338,61,69,8
203548,1654,349,61,61,0
264476,1010,320,61,71,10
259864,1518,312,61,66,5
263449,1446,319,61,67,6
251417,1525,332,61,69,8
262171,1625,337,61,76,15
264219,1466,324,61,82,21
241953,1653,360,61,71,10
264482,1537,332,61,61,0
259114,1451,323,61,71,10
246821,1597,337,61,73,12
244010,1651,341,61,69,8
260648,1486,348,61,68,7
256296,1602,342,61,66,5
251176,1434,313,61,77,16
212776,1506,326,61,61,0
237095,1473,320,61,61,0
254246,1391,312,61,76,15
263718,1574,341,61,67,6
262950,1540,337,61,65,4
259877,1539,335,61,74,13
238117,1580,342,61,69,8
224546,1649,354,61,62,1
263973,1448,300,61,71,10
259620,1459,318,61,70,9
257060,1383,297,61,75,14
245796,1449,323,61,68,7
240420,1399,307,61,73,12
186147,1143,352,61,61,0
251427,1532,344,61,74,13
223011,979,345,61,64,3
253474,1551,331,61,77,16
240674,1657,353,61,72,11
224088,1698,356,61,61,0
244567,954,327,61,64,3
254194,1097,338,61,61,0
202583,1075,336,61,61,0
247001,1672,361,61,70,9
246233,1573,352,61,70,9
240345,1689,371,61,73,12
219865,1606,341,61,63,2
251352,1605,351,61,69,8
240856,819,310,61,71,10
226264,1541,333,61,66,5
264664,1592,340,61,72,11
233687,1453,322,61,68,7
261334,1567,338,61,62,1
242134,1617,344,61,70,9
226006,1561,330,61,62,1
258261,1601,347,61,62,1
257237,1077,360,61,70,9
251349,1453,313,61,74,13
210901,1568,341,61,61,0
247508,1547,329,61,66,5
245716,1425,322,61,69,8
264660,1573,344,61,74,13
262356,1423,302,61,64,3
257235,1018,347,61,74,13
251603,1655,359,61,69,8
244179,1562,339,61,74,13
254722,1396,309,61,72,11
224731,1683,364,61,61,0
233691,897,320,61,67,6
226800,1466,323,61,72,11
248050,1601,338,61,74,13
241650,1712,367,61,71,10
240882,1515,320,61,71,10
263154,1003,340,61,70,9
195057,968,338,61,61,0
255729,1389,306,61,62,1
251889,1560,329,61,72,11
237553,883,327,61,72,11
236785,1569,343,61,69,8
263921,1484,324,61,75,14
260335,1421,313,61,61,0
261083,1550,342,61,75,14
258031,1011,336,61,74,13
254959,1414,296,61,71,10
254191,982,337,61,61,0
248559,1453,314,61,67,6
235247,1541,329,61,69,8
230895,1512,331,61,66,5
263663,1427,305,61,69,8
254702,1396,305,61,69,8
255213,1513,339,61,69,8
230893,980,348,61,68,7
241875,1524,320,61,71,10
150995,1505,329,61,61,0
264147,1612,345,61,76,15
258644,1568,337,61,71,10
257480,870,328,61,70,9
255176,1504,317,61,61,0
251848,1516,324,61,65,4
205139,1465,323,61,63,2
244563,1789,380,61,70,9
247123,1539,334,61,71,10
253779,1629,340,61,61,0
261971,1536,339,61,80,19
246100,1646,357,61,73,12
255828,1604,350,61,71,10
260436,1418,302,61,73,12
236234,1382,296,61,75,14
221525,1379,295,61,65,4
240725,1511,319,61,72,11
255829,1546,330,61,73,12
256853,1447,314,61,81,20
209750,1156,348,61,65,4
233814,1315,288,61,72,11
245334,1669,356,61,70,9
247638,1655,344,61,61,0
248662,1488,315,61,72,11
264535,962,332,61,64,3
259528,1535,327,61,76,15
187338,1557,324,61,61,0
262098,1607,345,61,69,8
244942,1363,295,61,70,9
244178,962,348,61,70,9
260561,1341,286,61,76,15
264657,1433,306,61,74,13
264401,1369,290,61,70,9
259280,1554,337,61,76,15
251856,1617,346,61,69,8
231120,1598,346,61,61,0
255183,1623,348,61,66,5
263631,1501,328,61,71,10
259534,1450,321,61,69,8
247245,1650,358,61,73,12
253898,1497,320,61,73,12
245453,1585,333,61,68,7
255436,1528,335,61,69,8
264652,1554,333,61,77,16
263628,1424,314,61,73,12
261323,1453,313,61,70,9
259531,1612,344,61,73,12
239051,1323,286,61,62,1
225739,1369,297,61,61,0
262347,1652,354,61,61,0
255434,1458,315,61,78,17
256002,1573,349,61,71,10
254694,1579,352,61,70,9
263594,1582,349,61,75,14
256172,987,336,61,68,7
239016,1731,368,61,67,6
248488,1437,315,61,73,12
260264,1479,332,61,79,18
263081,1494,335,61,69,8
263337,939,332,61,65,4
262057,1589,346,61,74,13
246954,1533,334,61,67,6
257194,1539,333,61,69,8
257962,1444,319,61,68,7
228267,1322,271,61,61,0
239019,949,327,61,71,10
257707,1646,343,61,73,12
258988,1388,298,61,61,0
224322,1131,353,61,71,10
262573,1418,311,61,74,13
202925,1480,323,61,63,2
208813,1680,352,61,64,3
240813,1530,341,61,67,6
245165,1489,327,61,64,3
251054,1500,333,61,66,5
260014,1584,335,61,79,18
262062,1635,353,61,80,19
262831,1519,325,61,66,5
260527,1018,339,61,65,4
251312,1418,317,61,70,9
261040,1370,304,61,69,8
224936,1631,349,61,64,3
212392,1139,350,61,65,4
264104,1512,329,61,75,14
258983,944,332,61,72,11
176839,1587,340,61,61,0
52679,1076,340,61,61,0
226504,1402,305,61,66,5
240328,1604,351,61,66,5
264096,1484,318,61,81,20
234912,1663,362,61,61,0
241312,1568,338,61,66,5
258976,1681,351,61,78,17
262561,876,325,61,72,11
241825,1624,343,61,74,13
216226,1649,350,61,61,0
221346,1550,337,61,67,6
248482,1500,336,61,70,9
255394,1601,334,61,75,14
213667,1427,313,61,64,3
235939,1497,323,61,70,9
256931,1342,283,61,77,16
203428,1694,366,61,62,1
206500,1064,348,61,65,4
258468,1527,329,61,77,16
236197,1348,276,61,61,0
239013,1613,347,61,70,9
239783,1463,317,61,69,8
248487,1593,339,61,75,14
253607,1458,322,61,69,8
242609,1559,317,61,62,1
247985,1708,370,61,61,0
250801,1537,335,61,75,14
261452,1348,298,61,64,3
264524,1620,347,61,71,10
263500,1651,349,61,73,12
246603,967,342,61,71,10
245067,1596,335,61,70,9
244811,1425,305,61,68,7
254282,1337,287,61,66,5
263498,904,333,61,72,11
255305,1520,335,61,77,16
264265,896,342,61,79,18
222279,1559,333,61,61,0
257862,907,335,61,61,0
239942,1590,338,61,70,9
250949,1598,345,61,72,11
227653,1071,346,61,62,1
261188,1507,329,61,72,11
260420,1412,297,61,70,9
255812,935,335,61,71,10
250948,1501,333,61,70,9
239428,1564,336,61,68,7
233284,1487,334,61,62,1
210244,1651,355,61,61,0
262212,1492,318,61,69,8
259907,1355,298,61,66,5
258627,1498,330,61,75,14
241475,1600,352,61,61,0
246604,1565,337,61,77,16
235597,989,324,61,61,0
261554,1697,361,61,71,10
243021,1630,342,61,68,7
246195,1622,353,61,71,10
253875,1476,321,61,61,0
261299,1630,340,61,79,18
261555,1608,345,61,78,17
264531,1680,359,61,65,4
258642,1407,296,61,75,14
244818,1609,341,61,67,6
240722,981,351,61,65,4
262226,1555,348,61,72,11
260433,1548,326,61,67,6
260177,1489,330,61,66,5
259153,967,372,61,70,9
252241,961,330,61,73,12
248145,1473,318,61,76,15
246353,1516,341,61,72,11
230737,1563,338,61,68,7
261456,1626,345,61,66,5
247376,1377,303,61,64,3
244048,1440,319,61,73,12
166736,1643,348,61,61,0
212816,1521,308,61,61,0
263760,996,339,61,74,13
259919,1386,296,61,62,1
257871,1625,335,61,69,8
253774,1578,322,61,73,12
236487,1565,342,61,66,5
247237,1569,346,61,71,10
241349,1621,357,61,61,0
215685,1697,366,61,61,0
253828,1738,375,61,70,9
240772,1612,342,61,73,12
140420,1031,331,61,61,0
264324,1532,327,61,68,7
261251,1480,313,61,73,12
254851,1670,360,61,77,16
252547,1542,334,61,70,9
237699,1584,342,61,69,8
208771,1704,359,61,63,2
262787,1516,337,61,71,10
259970,1513,331,61,69,8
247426,1505,328,61,71,10
264066,1381,302,61,77,16
258945,1481,320,61,74,13
237185,1763,369,61,67,6
255360,1563,345,61,76,15
251264,1379,303,61,70,9
263296,1430,302,61,73,12
260735,863,334,61,63,2
258687,1407,305,61,71,10
246399,1519,330,61,71,10
200319,1603,339,61,61,0
263551,1493,320,61,75,14
260990,1620,339,61,80,19
186494,1093,332,61,61,0
254084,1698,366,61,71,10
261765,1612,351,61,71,10
248445,1397,308,61,66,5
263046,1509,326,61,73,12
262287,1591,346,61,62,1
255374,1627,348,61,71,10
252302,1605,350,61,77,16
235918,1417,310,61,63,2
231310,1580,341,61,66,5
252301,1649,358,61,67,6
237965,1535,340,61,70,9
229005,1407,300,61,64,3
264589,1405,298,61,79,18
240524,1603,355,61,67,6
262284,1584,344,61,71,10
260235,1665,363,61,79,18
192651,1600,345,61,61,0
262283,1508,322,61,78,17
238473,1388,308,61,71,10
262793,1556,335,61,69,8
258184,1656,365,61,69,8
219272,1649,361,61,64,3
205704,1548,329,61,61,0
201864,1151,340,61,61,0
232583,1407,317,61,62,1
250758,1464,317,61,64,3
231046,1036,338,61,69,8
152454,1758,370,61,61,0
213894,1610,353,61,62,1
239998,1330,281,61,74,13
244093,1529,344,61,66,5
223941,1587,352,61,64,3
263355,1459,296,61,79,18
253627,1037,327,61,64,3
261563,1641,346,61,75,14
238780,1350,308,61,66,5
247740,1465,314,61,79,18
254396,1141,348,61,68,7
231615,1670,365,61,67,6
244671,1500,320,61,70,9
191679,1630,334,61,61,0
258751,1524,323,61,73,12
264128,1594,341,61,71,10
259264,1479,319,61,68,7
244929,1461,318,61,73,12
253121,1454,316,61,72,11
192961,1070,347,61,61,0
264642,1566,334,61,68,7
237506,1656,352,61,69,8
239042,1715,360,61,63,2
242370,1477,324,61,73,12
252098,1591,338,61,61,0
253123,1695,360,61,70,9
261571,1583,343,61,71,10
264132,1585,344,61,73,12
247748,1707,359,61,69,8
256196,1454,317,61,81,20
259780,923,328,61,66,5
225467,1661,362,61,66,5
257722,1485,321,61,65,4
241277,1518,327,61,71,10
256442,1648,351,61,70,9
170877,1026,332,61,61,0
226429,1569,335,61,69,8
263604,1516,320,61,76,15
225716,1700,358,61,61,0
191924,1060,339,61,61,0
264629,1616,343,61,71,10
203189,1534,333,61,61,0
246709,1376,304,61,69,8
245174,1434,307,61,69,8
246454,1380,308,61,76,15
247734,1466,324,61,70,9
251574,1555,336,61,70,9
251830,1582,347,61,77,16
254646,1403,301,61,68,7
258230,1644,363,61,76,15
227767,1676,348,61,61,0
241335,1723,377,61,66,5
252599,1671,348,61,71,10
259255,870,322,61,63,2
212664,1653,357,61,61,0
246456,1564,353,61,68,7
255160,1509,336,61,75,14
232633,1008,338,61,66,5
254905,1554,332,61,76,15
222394,1472,312,61,65,4
262467,1582,339,61,61,0
257819,1402,312,61,62,1
261483,1410,303,61,71,10
260255,1442,312,61,73,12
239221,1407,331,61,69,8
236662,1692,374,61,75,14
253814,1698,353,61,61,0
254838,1448,306,61,72,11
258934,1479,315,61,72,11
243831,1480,322,61,68,7
261495,1458,323,61,81,20
239480,1564,341,61,70,9
244600,1602,339,61,72,11
260216,1598,347,61,68,7
260728,1452,322,61,74,13
231033,1602,343,61,63,2
242809,1582,351,61,67,6
247673,1556,342,61,61,0
256889,1418,314,61,69,8
259193,1624,354,61,72,11
240506,1573,326,61,66,5
259194,1450,327,61,74,13
262268,1380,296,61,70,9
245628,1350,289,61,71,10
252796,1513,328,61,75,14
206142,1692,369,61,61,0
229184,1572,334,61,69,8
248384,1585,336,61,73,12
228767,1588,336,61,69,8
256832,1580,334,61,79,18
258880,1505,320,61,66,5
229185,1346,298,61,68,7
251201,1625,338,61,79,18
242804,1006,337,61,66,5
262772,1586,343,61,64,3
260723,1447,303,61,74,13
247405,1296,283,61,70,9
255081,1729,366,61,66,5
192361,1625,336,61,61,0
234858,969,340,61,65,4
242282,1594,348,61,69,8
259178,1534,341,61,75,14
261482,1580,343,61,66,5
246123,1514,323,61,78,17
254315,1561,338,61,75,14
255339,1515,326,61,76,15
199021,1696,353,61,61,0
134765,1685,345,61,61,0
221293,1483,319,61,64,3
230765,1094,346,61,67,6
262254,876,334,61,65,4
243827,1499,330,61,74,13
242286,1500,328,61,70,9
260206,1588,337,61,61,0
262511,1451,308,61,74,13
263279,1534,332,61,72,11
256367,1415,310,61,71,10
259695,928,326,61,61,0
264048,965,324,61,68,7
232816,986,346,61,68,7
243056,1626,337,61,74,13
252016,1521,315,61,76,15
247409,1429,300,61,70,9
242034,1542,330,61,70,9
193906,1466,319,61,61,0
263234,887,333,61,74,13
251772,1025,338,61,61,0
262548,1511,323,61,61,0
223894,1432,313,61,61,0
187797,1310,274,61,61,0
251285,1051,340,61,70,9
264085,1385,309,61,69,8
255636,1613,347,61,72,11
251028,1550,345,61,71,10
247444,1558,340,61,71,10
237204,1553,342,61,70,9
211604,1120,348,61,64,3
262804,1728,372,61,63,2
257171,1603,334,61,77,16
251539,1455,332,61,72,11
243603,1555,343,61,72,11
169619,1609,333,61,61,0
220819,1677,367,61,61,0
219795,1068,350,61,65,4
263571,1615,362,61,75,14
263059,1583,336,61,76,15
245906,1469,314,61,80,19
240786,1629,361,61,66,5
263570,1445,317,61,71,10
261265,1478,316,61,76,15
243345,1430,305,61,73,12
246121,1690,357,61,72,11
237201,1176,349,61,62,1
236689,1670,348,61,66,5
253840,1084,350,61,65,4
241552,1604,345,61,73,12
258447,1364,281,61,70,9
246671,953,341,61,77,16
240489,940,331,61,77,16
263574,1537,330,61,67,6
263319,1648,355,61,67,6
241818,1567,338,61,68,7
245150,1539,336,61,73,12
248477,1569,333,61,70,9
241053,1450,313,61,69,8
227997,1520,331,61,66,5
259176,1677,364,61,68,7
263016,1447,318,61,75,14
222621,1115,340,61,61,0
264349,1563,339,61,77,16
260252,1632,353,61,64,3
231580,1612,344,61,70,9
252059,1532,331,61,70,9
238491,1491,332,61,69,8
263323,1527,327,61,70,9
211095,1481,327,61,61,0
243866,1526,341,61,71,10
195481,1577,332,61,61,0
241048,1569,332,61,66,5
229783,1102,347,61,67,6
247447,1568,327,61,74,13
264088,934,329,61,65,4
225432,1099,345,61,68,7
237208,1678,369,61,63,2
241817,1497,332,61,70,9
263311,1484,321,61,69,8
258456,1531,324,61,76,15
207513,1743,359,61,61,0
220057,1424,313,61,63,2
241891,1344,294,60,68,8
236771,1423,305,60,60,0
225251,1634,348,60,61,1
248547,1566,328,60,67,7
252386,1447,311,60,77,17
222179,1566,337,60,60,0
263908,1477,312,60,75,15
248803,1584,345,60,75,15
251107,1620,338,60,71,11
259299,1383,309,60,75,15
258529,1545,336,60,73,13
264420,1605,341,60,71,11
243428,1383,300,60,75,15
242149,1600,358,60,70,10
264418,1554,324,60,68,8
263647,1366,294,60,67,7
252897,1634,354,60,77,17
245729,1529,331,60,76,16
222177,1094,348,60,60,0
263393,1582,334,60,72,12
260320,1553,339,60,65,5
243168,1489,329,60,70,10
240608,1460,321,60,70,10
233440,1523,330,60,65,5
240863,1610,340,60,74,14
264416,1648,364,60,76,16
257247,1613,341,60,75,15
233446,1593,349,60,60,0
253919,1469,322,60,69,9
228061,1635,356,60,60,0
242917,1474,307,60,74,14
261616,1619,337,60,76,16
246246,834,318,60,70,10
252006,1493,327,60,71,11
247908,1580,339,60,70,10
259172,1440,314,60,71,11
261220,1382,301,60,70,10
221285,1673,367,60,61,1
236901,1651,353,60,67,7
243045,1403,305,60,62,2
210790,1656,359,60,60,0
221798,1052,333,60,62,2
243302,1420,311,60,64,4
256358,1568,341,60,78,18
257254,1462,310,60,72,12
257638,831,323,60,72,12
260454,1429,311,60,70,10
210791,1093,346,60,60,0
243047,1503,327,60,73,13
252007,1527,325,60,71,11
191336,1039,331,60,60,0
244073,926,326,60,68,8
260969,919,327,60,71,11
263018,1370,301,60,71,11
239460,1640,349,60,65,5
171620,1638,339,60,60,0
264548,1579,343,60,75,15
251235,1666,351,60,70,10
260959,1500,322,60,77,17
258911,1390,304,60,70,10
204383,1662,353,60,60,0
264031,1595,337,60,69,9
259424,1376,291,60,80,20
262241,1519,337,60,65,5
158305,1670,341,60,60,0
254817,1583,350,60,72,12
260449,1399,299,60,70,10
228194,1634,348,60,60,0
244066,1016,339,60,70,10
244322,1549,347,60,61,1
255074,1467,319,60,73,13
256610,1539,323,60,78,18
260450,1336,280,60,69,9
260706,1502,319,60,66,6
228195,1680,360,60,60,0
239203,921,324,60,69,9
244835,1600,346,60,65,5
263275,1635,354,60,76,16
258667,1534,336,60,72,12
263021,1349,288,60,62,2
183533,1073,349,60,60,0
247277,1585,351,60,69,9
238061,1642,351,60,70,10
264173,1394,304,60,71,11
256236,1559,340,60,67,7
254700,1531,334,60,65,5
251372,1655,360,60,66,6
264172,1385,304,60,72,12
257259,1648,354,60,70,10
260586,1379,291,60,79,19
245994,1679,353,60,72,12
262634,1502,332,60,74,14
251369,928,331,60,68,8
245481,1451,323,60,67,7
228073,1669,352,60,61,1
261096,1474,319,60,68,8
257511,1529,325,60,75,15
238567,1710,366,60,60,0
224231,1496,322,60,61,1
223719,1572,323,60,62,2
247533,1446,314,60,65,5
255981,999,350,60,74,14
255853,1528,308,60,60,0
264351,842,326,60,75,15
241263,1550,337,60,70,10
260975,1457,314,60,61,1
262768,1431,321,60,66,6
215408,995,328,60,60,0
244592,1527,337,60,76,16
264561,1474,320,60,77,17
254321,1617,337,60,71,11
244082,1486,312,60,64,4
248178,1500,321,60,61,1
255898,1461,312,60,70,10
262811,1322,286,60,71,11
258715,1520,329,60,67,7
258972,1346,296,60,74,14
256669,1466,325,60,70,10
261277,1603,349,60,65,5
264094,1520,332,60,73,13
222190,1589,339,60,60,0
263150,1550,336,60,75,15
262382,1547,322,60,70,10
260254,1348,286,60,71,11
260778,1583,339,60,74,14
205727,1054,335,60,63,3
231421,1014,349,60,67,7
257244,1665,358,60,78,18
261470,1417,308,60,69,9
257630,1542,323,60,76,16
255998,1424,301,60,75,15
238846,1714,367,60,64,4
263678,1613,340,60,76,16
263166,1474,325,60,66,6
251645,1542,324,60,70,10
245501,1500,334,60,69,9
264189,1512,328,60,80,20
257017,1356,301,60,63,3
263421,1542,341,60,77,17
261884,1394,310,60,75,15
259324,1602,330,60,72,12
255484,1369,300,60,65,5
263932,1435,321,60,76,16
261883,1514,326,60,67,7
258042,1401,307,60,71,11
239354,996,330,60,67,7
231674,1514,326,60,60,0
264157,1554,332,60,70,10
263008,1588,345,60,75,15
234099,1526,322,60,73,13
259327,1384,315,60,74,14
209169,1373,287,60,60,0
211217,1657,354,60,61,1
245521,1547,335,60,60,0
253969,1460,330,60,79,19
263442,1356,296,60,70,10
236818,1668,358,60,71,11
237842,1725,362,60,67,7
254482,1560,346,60,80,20
257042,1612,339,60,74,14
263955,1470,315,60,74,14
264467,1456,303,60,70,10
251411,1438,308,60,70,10
255507,1545,328,60,70,10
257811,1602,348,60,69,9
245780,1509,323,60,71,11
257790,1538,334,60,73,13
263935,1596,333,60,72,12
247295,863,316,60,66,6
254207,1445,317,60,66,6
258041,1440,291,60,78,18
255737,1454,314,60,63,3
257807,1642,357,60,63,3
261614,1523,324,60,74,14
262641,1442,313,60,83,23
263168,1578,340,60,81,21
255488,1359,300,60,65,5
262401,1518,325,60,67,7
264705,1621,354,60,70,10
229377,1559,336,60,69,9
237825,1502,325,60,74,14
223982,1118,337,60,65,5
257518,1366,297,60,67,7
263151,1483,333,60,70,10
255481,1615,342,60,67,7
264175,1536,343,60,74,14
221423,1461,319,60,60,0
238575,1300,289,60,67,7
251631,1579,343,60,74,14
252911,929,330,60,77,17
261359,1499,331,60,68,8
263920,875,329,60,68,8
264688,1508,321,60,71,11
252912,1638,341,60,77,17
247025,1617,343,60,77,17
258801,1574,334,60,60,0
264178,1560,331,60,69,9
239858,1560,338,60,60,0
231929,1570,336,60,67,7
263673,984,354,60,72,12
262905,1522,339,60,69,9
253688,1056,336,60,73,13
243960,1462,321,60,72,12
264696,1553,340,60,72,12
263928,1497,322,60,65,5
262904,1419,299,60,70,10
257014,907,328,60,70,10
252918,1523,326,60,76,16
264694,1631,353,60,63,3
246773,1579,344,60,67,7
260084,1471,319,60,77,17
259828,1336,289,60,70,10
256500,1392,323,60,82,22
260083,1545,326,60,72,12
231923,1696,360,60,65,5
264179,1625,343,60,78,18
248306,1634,345,60,60,0
254480,1492,330,60,80,20
255247,1476,319,60,72,12
243615,1512,330,60,62,2
256173,924,323,60,75,15
258984,1625,351,60,70,10
251049,1461,315,60,69,9
255401,1292,284,60,72,12
251306,1704,361,60,72,12
256426,1473,322,60,77,17
259754,1481,312,60,69,9
258288,885,316,60,68,8
261034,1352,290,60,66,6
253612,1637,351,60,69,9
256685,1567,341,60,75,15
233394,1584,344,60,69,9
223918,1700,355,60,62,2
225198,1387,303,60,60,0
228526,1031,320,60,62,2
241582,1496,331,60,66,6
208559,1574,339,60,62,2
255407,1417,326,60,70,10
261552,1593,346,60,69,9
252849,1502,315,60,72,12
261553,1429,304,60,68,8
244904,1472,313,60,67,7
253351,1520,332,60,65,5
246695,1331,292,60,74,14
242854,1541,333,60,76,16
255391,1566,336,60,80,20
222624,1611,351,60,60,0
244128,1642,349,60,66,6
257184,1500,318,60,68,8
260512,1562,340,60,60,0
263585,1458,306,60,63,3
258977,1474,321,60,72,12
263330,1628,335,60,76,16
251554,1579,342,60,71,11
254882,1634,339,60,74,14
262307,1655,349,60,74,14
221603,1669,342,60,60,0
224675,1696,362,60,61,1
253859,1518,335,60,67,7
261539,1519,333,60,74,14
246180,1726,365,60,72,12
253860,1427,312,60,67,7
213157,1584,326,60,61,1
259493,1517,328,60,74,14
263602,1659,349,60,74,14
263603,1575,338,60,76,16
259854,1690,361,60,70,10
256267,1550,326,60,66,6
256264,1522,326,60,68,8
260872,1575,335,60,68,8
219657,1053,332,60,66,6
245001,1461,321,60,70,10
245769,1583,331,60,71,11
260617,1518,340,60,76,16
240650,1497,323,60,73,13
259594,1486,320,60,69,9
243211,1495,329,60,73,13
257035,1459,320,60,60,0
257715,1507,327,60,66,6
257803,1528,344,60,69,9
243980,1534,334,60,66,6
247308,1427,305,60,69,9
247820,1403,307,60,74,14
257036,1520,330,60,73,13
257548,1621,360,60,68,8
207886,1673,352,60,61,1
256782,1517,333,60,76,16
259598,1647,353,60,71,11
187144,1050,333,60,60,0
243720,893,330,60,70,10
241160,1573,326,60,74,14
222216,1532,323,60,60,0
239540,1291,280,60,73,13
224693,1630,345,60,60,0
248577,1386,302,60,65,5
253441,1436,314,60,75,15
216578,1573,330,60,60,0
251906,1430,313,60,61,1
257538,1578,347,60,67,7
260098,1471,329,60,77,17
226563,1511,314,60,66,6
228611,1060,337,60,60,0
231171,1508,323,60,60,0
236292,1324,279,60,71,11
246789,1703,367,60,67,7
214278,1479,313,60,60,0
255494,964,346,60,73,13
258566,1641,356,60,63,3
260614,948,327,60,70,10
245255,1485,319,60,69,9
259335,1425,302,60,79,19
240736,1533,317,60,66,6
251506,1565,340,60,62,2
260059,1571,341,60,72,12
251837,910,327,60,68,8
226496,1568,329,60,60,0
213696,1673,366,60,65,5
258239,979,335,60,74,14
247999,1497,323,60,60,0
243135,1492,330,60,70,10
166847,1711,350,60,60,0
223167,1490,326,60,66,6
262591,1535,340,60,67,7
258750,1696,356,60,72,12
264638,1618,345,60,70,10
261821,1340,292,60,61,1
252861,1608,340,60,70,10
236733,1537,333,60,62,2
263361,1505,320,60,72,12
263869,1409,296,60,71,11
257212,1432,313,60,66,6
255932,1358,285,60,77,17
250812,1472,324,60,73,13
248508,1408,307,60,74,14
255674,886,320,60,72,12
254906,851,326,60,66,6
243898,1676,363,60,73,13
246713,1380,300,60,74,14
245689,1386,298,60,73,13
264121,1372,293,60,77,17
263862,1431,319,60,69,9
261568,1638,348,60,67,7
231617,1603,350,60,65,5
245057,905,320,60,72,12
236485,1329,292,60,66,6
263112,1474,318,60,75,15
260551,1610,350,60,66,6
259783,886,321,60,65,5
259271,1304,275,60,67,7
258503,1575,334,60,74,14
250823,1627,357,60,75,15
205255,1534,332,60,61,1
263623,1472,318,60,73,13
263367,1491,323,60,72,12
259270,1528,334,60,61,1
257478,1633,350,60,63,3
255430,1522,332,60,78,18
259268,1447,322,60,76,16
233665,1530,336,60,66,6
234692,1596,348,60,60,0
260547,1609,350,60,74,14
258243,1424,314,60,68,8
254915,1427,310,60,69,9
246467,1475,327,60,69,9
240835,1410,313,60,70,10
261826,1553,348,60,69,9
245698,1505,328,60,74,14
242114,1605,343,60,72,12
240322,1486,321,60,67,7
264130,1646,340,60,68,8
257985,1029,343,60,68,8
214747,1683,361,60,60,0
243789,1476,320,60,69,9
260296,1493,323,60,65,5
241239,1493,318,60,65,5
264532,1671,354,60,69,9
237140,1619,356,60,61,1
245332,1644,358,60,71,11
247636,1457,319,60,63,3
263509,1422,314,60,73,13
247125,1592,348,60,67,7
253013,1450,322,60,63,3
263254,860,330,60,70,10
229718,1607,342,60,66,6
231510,1314,287,60,65,5
235606,974,332,60,68,8
250966,1409,315,60,60,0
254807,1536,341,60,80,20
251219,1478,319,60,73,13
248408,1334,287,60,76,16
256088,1560,342,60,66,6
262745,1666,357,60,73,13
247897,1667,357,60,66,6
258905,1487,317,60,77,17
236634,1547,339,60,73,13
255834,1512,320,60,70,10
261466,950,328,60,70,10
263771,1446,322,60,72,12
264027,1626,338,60,75,15
264283,1305,278,60,66,6
258907,1466,323,60,78,18
263252,1536,340,60,75,15
162899,1519,313,60,60,0
260941,1452,319,60,72,12
258383,895,339,60,65,5
260277,1423,305,60,74,14
256693,1621,356,60,65,5
241979,1588,339,60,74,14
240955,894,322,60,70,10
240187,1449,318,60,73,13
263502,1593,333,60,72,12
235086,914,322,60,69,9
236622,1489,327,60,65,5
243278,1507,317,60,69,9
247630,1619,343,60,67,7
194894,963,323,60,60,0
240463,1641,355,60,63,3
262480,1673,355,60,71,11
226387,1514,339,60,65,5
240208,1405,312,60,60,0
250960,1565,343,60,72,12
263761,1615,351,60,72,12
225873,1538,331,60,65,5
248401,1472,318,60,73,13
258641,962,358,60,77,17
258897,1458,315,60,71,11
236370,1386,307,60,60,0
252498,1445,319,60,72,12
261202,1500,321,60,74,14
261970,1625,343,60,70,10
262227,1500,327,60,76,16
232904,1516,327,60,67,7
251272,1474,332,60,73,13
226140,1691,355,60,63,3
262975,1546,338,60,68,8
263501,1611,341,60,73,13
223821,1268,262,60,60,0
244289,1612,349,60,78,18
165441,1645,339,60,60,0
220481,1266,278,60,65,5
149825,1495,302,60,60,0
264257,1430,311,60,66,6
264001,1467,319,60,69,9
261184,1442,317,60,60,0
261695,1693,356,60,63,3
261183,1443,304,60,78,18
247871,1606,343,60,72,12
261694,1638,348,60,64,4
258892,1467,319,60,70,10
258878,1464,317,60,65,5
251454,1675,362,60,75,15
231486,1591,347,60,60,0
263486,1425,321,60,75,15
261181,1452,296,60,74,14
255293,1625,343,60,73,13
237885,1325,289,60,67,7
262973,1375,296,60,73,13
252476,1534,337,60,72,12
239676,1665,351,60,69,9
261435,1550,325,60,74,14
260667,1539,327,60,74,14
259916,1381,305,60,67,7
255564,1435,306,60,72,12
246843,908,315,60,65,5
236359,1507,333,60,70,10
255042,1477,309,60,60,0
255810,1512,317,60,69,9
264515,1421,311,60,68,8
260419,1446,312,60,65,5
261187,1675,349,60,67,7
230980,1544,333,60,61,1
262981,1549,322,60,76,16
252229,1637,344,60,69,9
262214,1561,343,60,74,14
264262,833,310,60,67,7
204870,1364,299,60,61,1
262215,1424,319,60,71,11
202824,1608,342,60,60,0
246860,1577,333,60,80,20
233288,1534,342,60,65,5
254280,1515,327,60,72,12
247369,1636,337,60,71,11
259145,1356,292,60,69,9
263499,1633,344,60,60,0
264523,1570,341,60,73,13
239947,1601,343,60,70,10
242507,1668,352,60,67,7
260939,1660,354,60,74,14
262732,1462,320,60,75,15
263756,1476,313,60,75,15
224844,1323,278,60,63,3
255803,1321,290,60,68,8
235162,1709,368,60,61,1
259976,1444,303,60,72,12
261772,1509,331,60,78,18
229008,1081,336,60,67,7
264592,1465,307,60,68,8
241039,1551,333,60,71,11
229263,1679,344,60,69,9
225935,1456,310,60,63,3
242062,1625,351,60,74,14
234638,1421,307,60,67,7
264590,1462,322,60,75,15
263310,1520,328,60,70,10
253837,1203,351,60,66,6
252557,1448,315,60,63,3
235661,1646,344,60,70,10
260492,1548,336,60,79,19
255633,920,320,60,70,10
250764,1511,332,60,69,9
209548,1519,333,60,60,0
253579,1578,338,60,68,8
251275,1444,313,60,75,15
241035,1378,301,60,74,14
259466,983,332,60,74,14
246154,1586,347,60,77,17
226186,1604,345,60,60,0
214666,1652,351,60,61,1
262538,1546,336,60,67,7
259721,1404,277,60,75,15
237705,1504,347,60,71,11
253585,1344,298,60,66,6
260241,1370,293,60,76,16
229274,1080,356,60,66,6
256148,1482,319,60,70,10
228250,1504,329,60,62,2
253337,1393,306,60,62,2
257176,953,334,60,74,14
255896,1433,303,60,71,11
255384,1380,302,60,67,7
254872,1604,353,60,60,0
254615,902,321,60,68,8
187031,1545,329,60,60,0
261014,911,318,60,60,0
241558,1533,329,60,70,10
263318,1415,313,60,68,8
263061,1653,358,60,66,6
184980,1637,340,60,60,0
261777,1549,338,60,70,10
264596,1557,334,60,71,11
253843,1086,324,60,61,1
247955,1543,348,60,78,18
245907,1646,349,60,75,15
241299,1275,276,60,63,3
261010,1514,328,60,67,7
258450,1471,321,60,72,12
257426,1660,360,60,71,11
244370,1498,327,60,70,10
236946,1552,342,60,66,6
228498,1166,354,60,61,1
263826,1619,345,60,68,8
208988,1041,342,60,60,0
247105,1023,346,60,75,15
262493,1459,316,60,60,0
252440,1455,318,60,71,11
259099,1557,343,60,72,12
247067,959,329,60,65,5
246299,1528,343,60,67,7
225051,1347,289,60,63,3
212763,1124,348,60,65,5
260890,1322,273,60,67,7
260378,1372,299,60,70,10
258330,1452,314,60,78,18
257306,1711,352,60,73,13
229914,1761,386,60,63,3
243737,832,331,60,66,6
262937,1628,364,60,73,13
246552,1558,339,60,60,0
226844,1399,301,60,60,0
247063,1578,336,60,68,8
242454,1418,307,60,66,6
221974,1610,346,60,60,0
193557,1603,358,60,60,0
251157,928,322,60,71,11
243221,1570,349,60,69,9
239893,1551,342,60,69,9
238357,1534,319,60,67,7
229397,1172,344,60,66,6
262677,1406,304,60,60,0
246292,1588,335,60,69,9
230749,1154,338,60,68,8
263708,1450,312,60,61,1
245020,1454,317,60,74,14
255092,1637,350,60,72,12
246305,1576,329,60,70,10
260133,1578,336,60,68,8
251685,1489,323,60,69,9
258084,1524,331,60,74,14
256036,1595,340,60,75,15
209188,1584,335,60,60,0
261155,1541,330,60,69,9
252194,1537,320,60,75,15
251170,1414,298,60,73,13
239906,1520,332,60,71,11
233506,1426,316,60,64,4
261409,961,338,60,68,8
251169,1604,344,60,71,11
258080,1560,327,60,76,16
255772,1520,327,60,66,6
254496,1632,355,60,70,10
253216,889,330,60,77,17
252960,1603,354,60,75,15
240672,1513,332,60,70,10
259359,1497,333,60,61,1
259103,1344,304,60,66,6
252959,1418,319,60,78,18
260382,1639,353,60,63,3
256542,1449,320,60,69,9
246558,1401,295,60,65,5
228382,1543,335,60,67,7
210206,1521,327,60,60,0
248435,1523,335,60,72,12
259444,1431,316,60,73,13
260134,1277,277,60,68,8
262534,1350,303,60,66,6
258176,1478,313,60,76,16
202881,1690,348,60,60,0
246401,1478,322,60,74,14
261761,1579,335,60,66,6
228226,1592,341,60,68,8
260482,1513,325,60,77,17
207491,1547,322,60,60,0
259971,1381,304,60,69,9
262788,1467,327,60,67,7
259204,1693,357,60,65,5
247173,1348,303,60,75,15
258181,1239,342,60,70,10
208774,1533,335,60,61,1
261503,1543,324,60,60,0
261510,1487,321,60,74,14
261766,1460,312,60,77,17
240775,1456,315,60,70,10
242823,1598,349,60,70,10
246663,1453,304,60,66,6
257927,1623,349,60,74,14
258439,1510,332,60,74,14
263048,1464,321,60,68,8
235656,1656,349,60,63,3
246920,1644,359,60,69,9
262440,1622,334,60,67,7
235304,945,334,60,71,11
257152,1499,324,60,77,17
256383,1444,316,60,74,14
260212,1563,334,60,73,13
260473,1492,324,60,76,16
232565,880,319,60,60,0
238197,1495,327,60,66,6
258933,1385,304,60,71,11
225654,1592,343,60,63,3
232566,859,316,60,64,4
250998,1497,327,60,74,14
220023,1492,319,60,61,1
244087,1481,320,60,69,9
262776,1462,311,60,67,7
209784,1524,326,60,60,0
263289,1374,305,60,65,5
263801,1469,316,60,69,9
263547,1090,333,60,65,5
263807,1519,330,60,70,10
264571,1597,346,60,69,9
229243,1011,330,60,67,7
244091,1532,327,60,68,8
247931,1443,314,60,69,9
238716,1536,336,60,61,1
253820,1425,309,60,70,10
254844,1537,322,60,65,5
254845,1548,327,60,73,13
224638,1618,349,60,61,1
230014,1577,348,60,67,7
247166,1671,363,60,75,15
259198,1570,334,60,70,10
261157,1581,337,60,66,6
245270,1666,359,60,69,9
264487,1357,294,60,60,0
242225,1451,309,60,69,9
259889,1558,331,60,74,14
263474,1437,293,60,67,7
258098,1447,308,60,63,3
260402,1482,326,60,77,17
261170,919,324,60,77,17
261682,1474,316,60,60,0
251187,1583,344,60,85,25
260403,1606,349,60,71,11
252468,1584,346,60,71,11
258612,1646,353,60,73,13
264245,1477,324,60,69,9
233782,1307,277,60,68,8
243766,1564,332,60,71,11
263223,1517,322,60,70,10
202295,1483,309,60,60,0
247863,1613,344,60,69,9
257847,1476,318,60,70,10
234040,1529,335,60,68,8
239672,1623,346,60,76,16
258104,1520,325,60,76,16
220985,1033,336,60,65,5
236601,1550,345,60,69,9
243513,1319,266,60,74,14
225338,1500,314,60,66,6
255290,879,315,60,71,11
263483,1533,330,60,65,5
235579,1530,323,60,60,0
253233,1471,320,60,73,13
236849,1386,290,60,69,9
255837,1370,299,60,65,5
251184,1556,341,60,60,0
260825,1434,301,60,67,7
233946,1614,348,60,64,4
236762,1703,365,60,63,3
184282,1064,348,60,60,0
191528,1179,338,60,60,0
258089,1411,296,60,76,16
218585,1602,331,60,60,0
261417,1019,343,60,73,13
230698,1519,339,60,66,6
202795,1642,352,60,60,0
252459,1436,309,60,75,15
261675,1350,304,60,77,17
244012,1548,345,60,65,5
258348,1616,342,60,73,13
258087,1582,338,60,72,12
259116,1520,327,60,69,9
264237,1571,335,60,76,16
242221,1573,333,60,60,0
262958,1473,315,60,60,0
235054,1554,337,60,63,3
255534,1494,326,60,60,0
261422,1409,301,60,72,12
216111,1718,361,60,60,0
256047,1544,345,60,74,14
262704,1445,313,60,63,3
215088,1418,323,60,63,3
226352,1566,328,60,63,3
260445,1674,350,60,68,8
241977,1575,345,60,60,0
246877,1546,317,60,73,13
231634,1268,274,60,60,0
259025,1561,340,60,74,14
257489,1557,322,60,72,12
251345,989,341,60,77,17
262865,923,317,60,72,12
262609,1646,355,60,66,6
261584,975,332,60,65,5
229328,1547,334,60,65,5
213712,1655,348,60,62,2
258511,924,344,60,74,14
257231,1533,320,60,76,16
251855,1573,334,60,75,15
261326,1577,336,60,72,12
258509,1438,322,60,69,9
191437,1046,340,60,60,0
255693,1654,351,60,69,9
244172,921,340,60,68,8
241099,921,338,60,68,8
152523,1062,320,60,60,0
257482,1440,311,60,74,14
251594,1622,355,60,69,9
244170,1591,341,60,67,7
263882,1538,340,60,74,14
255272,1574,340,60,76,16
242984,1443,323,60,68,8
248265,1518,332,60,60,0
261576,1462,321,60,70,10
261320,970,337,60,71,11
263634,1556,335,60,77,17
262096,1459,324,60,79,19
252370,1411,298,60,67,7
264149,886,319,60,68,8
261336,1463,316,60,78,18
254680,1531,330,60,73,13
262616,1435,307,60,67,7
243159,1527,325,60,60,0
240599,1558,329,60,69,9
259026,1484,331,60,71,11
222422,1505,334,60,65,5
243157,1572,339,60,69,9
239573,909,324,60,62,2
228053,1467,319,60,67,7
225237,1640,347,60,67,7
254934,1543,335,60,76,16
262613,1521,327,60,61,1
252883,1525,339,60,71,11
257492,1251,322,60,78,18
263379,1461,320,60,72,12
139475,1597,335,60,60,0
231379,1374,286,60,66,6
247507,1560,331,60,74,14
258515,1456,312,60,78,18
263380,1488,319,60,66,6
264148,1619,343,60,69,9
139476,1135,335,60,60,0
263386,1616,350,59,59,0
235479,1447,320,59,60,1
264153,1307,288,59,64,5
259027,1394,307,59,73,14
256728,1485,317,59,69,10
253656,1544,324,59,68,9
261335,1491,336,59,76,17
257239,1354,281,59,79,20
264405,1536,329,59,68,9
264663,1534,334,59,73,14
260822,858,314,59,74,15
258518,1687,365,59,65,6
257238,1449,301,59,80,21
251093,1457,313,59,61,2
235994,1542,327,59,69,10
264404,1587,339,59,70,11
251091,1448,309,59,73,14
216794,1500,327,59,64,5
264544,1444,313,59,69,10
242906,1603,347,59,65,6
259177,1511,328,59,59,0
240747,1551,322,59,71,12
264555,1359,293,59,66,7
255850,1585,349,59,72,13
252522,1469,319,59,73,14
230762,1525,333,59,63,4
224618,1736,363,59,59,0
261225,1348,284,59,78,19
251753,901,325,59,69,10
264550,1547,331,59,69,10
263273,1547,329,59,76,17
261224,1490,315,59,79,20
253800,1451,318,59,67,8
252264,1525,318,59,70,11
261479,1408,315,59,72,13
254567,1480,325,59,67,8
260966,1491,327,59,75,16
237677,1606,337,59,65,6
190061,1109,344,59,59,0
227182,1511,330,59,66,7
227870,1592,352,59,64,5
243923,1294,279,59,73,14
260897,1467,314,59,73,14
256033,1445,316,59,71,12
253729,1493,327,59,78,19
244001,1109,347,59,68,9
255776,1621,337,59,75,16
244000,1309,295,59,66,7
242976,908,328,59,74,15
242464,1461,309,59,74,15
235808,1489,330,59,70,11
256799,1429,311,59,71,12
252191,1494,311,59,69,10
264223,1314,290,59,75,16
257822,1574,335,59,75,16
241694,1460,314,59,67,8
240486,1613,351,59,62,3
261221,1543,333,59,71,12
243539,1543,339,59,69,10
257624,1560,345,59,61,2
252509,1443,314,59,73,14
264285,884,322,59,68,9
256604,1437,305,59,74,15
263772,1417,301,59,71,12
260443,1526,340,59,73,14
208987,1072,329,59,59,0
263257,1392,312,59,70,11
242007,1513,327,59,66,7
257637,854,313,59,73,14
203863,1606,341,59,59,0
260182,1444,313,59,68,9
259926,1432,307,59,75,16
234070,1564,335,59,60,1
251477,1559,340,59,72,13
224853,1048,333,59,64,5
264533,1590,347,59,72,13
257629,1409,304,59,76,17
259165,1564,337,59,76,17
263262,1395,297,59,69,10
254558,1396,305,59,70,11
264549,1473,307,59,72,13
260452,1593,343,59,71,12
263268,1512,317,59,72,13
260451,1426,309,59,74,15
260195,1429,309,59,78,19
243042,1334,292,59,69,10
226658,1492,326,59,59,0
263522,1475,322,59,71,12
253793,1385,299,59,67,8
264545,1636,343,59,69,10
264033,1425,308,59,68,9
260191,1378,302,59,77,18
227679,1662,353,59,64,5
257374,994,334,59,68,9
255070,1474,328,59,76,17
248019,951,311,59,67,8
263488,1488,333,59,74,15
243410,1536,335,59,65,6
229192,1465,325,59,65,6
254279,1390,298,59,69,10
244551,986,334,59,68,9
216647,1458,310,59,62,3
264007,1555,331,59,68,9
244550,1557,326,59,74,15
233030,909,325,59,64,5
260933,1018,339,59,67,8
257348,1588,345,59,71,12
262980,1533,326,59,70,11
256320,1458,327,59,68,9
252736,1467,318,59,67,8
246592,1537,307,59,70,11
206144,1557,340,59,59,0
262947,1512,329,59,74,15
262976,1518,328,59,74,15
247359,1290,284,59,65,6
257342,914,311,59,68,9
262974,1583,350,59,71,12
262718,865,320,59,64,5
261437,1298,282,59,67,8
260157,1471,315,59,75,16
262728,1474,310,59,65,6
259144,1622,351,59,68,9
257745,1508,333,59,59,0
263241,1565,340,59,66,7
262739,1449,319,59,69,10
242258,1526,331,59,64,5
261969,1450,300,59,66,7
190033,1426,301,59,59,0
253521,1399,311,59,63,4
255312,1525,326,59,76,17
260943,1435,321,59,71,12
260431,1541,333,59,68,9
190031,1691,343,59,59,0
207951,1508,327,59,61,2
252749,1646,354,59,70,11
264525,1622,347,59,69,10
261196,1456,325,59,64,5
256331,1580,355,59,70,11
240715,1585,344,59,72,13
262219,1357,284,59,75,16
251978,1607,342,59,72,13
264522,1603,339,59,70,11
257865,1376,314,59,64,5
256329,1411,307,59,59,0
233289,1562,332,59,64,5
259900,868,326,59,64,5
254011,1382,284,59,77,18
260922,1409,307,59,70,11
258618,1561,332,59,68,9
261575,1389,296,59,70,11
263624,1393,306,59,69,10
248264,1555,334,59,65,6
227529,1067,333,59,65,6
247753,1429,301,59,67,8
258505,1629,346,59,75,16
261321,1495,316,59,70,11
263114,1370,291,59,78,19
260554,1461,308,59,79,20
260810,1370,297,59,74,15
263116,900,327,59,76,17
236748,1440,316,59,59,0
263885,1437,317,59,69,10
264141,1446,315,59,79,20
253390,1421,313,59,66,7
260558,1571,338,59,74,15
228047,1744,373,59,65,6
250831,878,325,59,81,22
247248,1306,286,59,74,15
255440,1552,325,59,73,14
243153,1480,325,59,70,11
260038,1470,312,59,68,9
258758,1511,329,59,75,16
243910,1423,305,59,69,10
208067,1089,344,59,59,0
247866,899,330,59,76,17
264506,1500,324,59,74,15
257081,1363,293,59,75,16
255033,1454,325,59,66,7
246841,891,321,59,69,10
252472,1353,302,59,76,17
246328,1414,301,59,70,11
238904,1492,319,59,65,6
262339,1413,309,59,70,11
215491,1033,330,59,63,4
236742,1550,333,59,66,7
262083,1586,335,59,70,11
202180,1469,315,59,59,0
228292,1668,357,59,64,5
255940,1619,351,59,70,11
258500,1463,312,59,76,17
262597,1389,296,59,72,13
255941,1464,324,59,67,8
256965,956,318,59,74,15
260549,1352,290,59,73,14
255778,1618,347,59,75,16
245164,872,322,59,65,6
252707,1465,320,59,71,12
239006,1596,344,59,72,13
253088,1391,305,59,68,9
252320,1391,306,59,72,13
240544,1595,349,59,67,8
263584,1587,343,59,59,0
259999,1465,318,59,59,0
257183,1600,342,59,68,9
258974,1428,311,59,66,7
257437,1575,346,59,75,16
264353,1480,320,59,73,14
257181,1551,337,59,67,8
259996,1564,345,59,59,0
256156,863,317,59,66,7
252572,1456,308,59,71,12
263068,1451,319,59,71,12
258203,1393,301,59,76,17
260506,1491,313,59,60,1
256672,1487,326,59,77,18
247202,960,328,59,70,11
239222,1574,341,59,69,10
261745,1499,320,59,77,18
262261,1478,331,59,68,9
250996,1486,323,59,69,10
261235,1466,324,59,70,11
243059,1548,327,59,67,8
237171,909,319,59,65,6
259442,1378,302,59,83,24
264562,1583,335,59,75,16
191857,1607,343,59,59,0
258978,1402,297,59,74,15
262769,1458,309,59,59,0
243824,1583,342,59,62,3
245359,933,326,59,68,9
261283,1384,304,59,76,17
251043,1496,328,59,66,7
244643,1533,333,59,65,6
261026,1489,328,59,71,12
255642,1448,323,59,66,7
262554,1506,324,59,64,5
258457,1352,287,59,77,18
263568,1475,328,59,67,8
251537,1425,309,59,68,9
264593,1535,316,59,71,12
255888,1595,345,59,70,11
243088,1684,361,59,62,3
239248,919,304,59,71,12
224400,1309,294,59,66,7
217232,1617,346,59,59,0
188815,860,308,59,59,0
242585,930,326,59,63,4
259726,1572,332,59,67,8
257166,1283,283,59,71,12
263054,1505,337,59,77,18
261517,1467,318,59,72,13
253171,867,323,59,73,14
261874,1351,293,59,65,6
261362,1510,318,59,68,9
237714,1573,344,59,65,6
241298,1472,311,59,59,0
259474,1582,329,59,70,11
260498,1356,304,59,62,3
261528,1453,314,59,76,17
259224,1571,331,59,68,9
263064,1463,330,59,76,17
240535,1597,342,59,73,14
263063,849,316,59,77,18
262551,1604,352,59,67,8
240534,1554,330,59,64,5
260501,1519,337,59,69,10
258709,1413,304,59,71,12
255893,888,312,59,67,8
245397,1604,342,59,73,14
251540,1477,316,59,70,11
243092,1567,338,59,68,9
261523,1386,287,59,60,1
235155,899,313,59,65,6
262773,1601,359,59,60,1
256886,1463,332,59,65,6
261411,1539,333,59,73,14
258805,1505,322,59,73,14
238073,1363,291,59,65,6
261112,1606,337,59,69,10
246008,1588,348,59,65,6
229368,956,316,59,64,5
263416,1617,339,59,69,10
253943,1569,339,59,72,13
222199,1641,358,59,59,0
234997,1466,307,59,65,6
236794,977,316,59,63,4
241396,1643,352,59,68,9
262644,1484,321,59,66,7
264076,1507,322,59,74,15
243595,1513,323,59,67,8
235915,1526,330,59,64,5
254858,1457,312,59,75,16
243594,1037,330,59,68,9
261369,1352,282,59,69,10
251386,1561,337,59,70,11
224631,1550,339,59,62,3
257532,1456,320,59,67,8
260095,984,317,59,73,14
239359,1545,337,59,67,8
262398,1546,329,59,68,9
244733,1479,320,59,68,9
264445,1437,321,59,77,18
198909,1525,326,59,59,0
263165,1610,341,59,70,11
255228,1457,310,59,68,9
255738,1624,337,59,71,12
247804,1451,310,59,70,11
210684,1432,309,59,60,1
258555,916,317,59,79,20
255483,1422,321,59,62,3
248315,1506,318,59,65,6
264699,1610,336,59,74,15
264187,1377,287,59,71,12
261513,1523,326,59,75,16
247177,1510,339,59,59,0
262537,1567,338,59,74,15
255611,1575,328,59,77,18
253055,1416,305,59,70,11
165502,1114,336,59,59,0
260477,1467,333,59,72,13
252797,1487,316,59,68,9
247677,1696,366,59,65,6
252540,1505,320,59,70,11
261755,981,323,59,70,11
264059,1548,330,59,74,15
262024,1631,334,59,73,14
261241,1411,304,59,76,17
259705,895,323,59,68,9
261496,1378,295,59,74,15
258167,1409,309,59,75,16
252535,1621,344,59,59,0
239735,1562,341,59,69,10
237175,1513,329,59,71,12
256127,1454,313,59,74,15
260479,1562,343,59,74,15
252544,1680,345,59,73,14
256384,1356,290,59,71,12
259720,1352,303,59,73,14
257672,1643,346,59,64,5
263047,1428,318,59,68,9
256390,1617,343,59,76,17
251525,1447,312,59,69,10
261508,1468,315,59,74,15
251780,1477,316,59,59,0
260739,1541,326,59,72,13
259459,1474,325,59,67,8
258947,1591,338,59,74,15
258179,1491,328,59,71,12
255363,1598,331,59,69,10
263298,1528,330,59,76,17
261760,1575,338,59,61,2
261248,1484,325,59,59,0
239857,975,309,59,63,4
254704,1359,274,59,59,0
253168,1566,351,59,70,11
198825,1648,341,59,59,0
264364,1568,334,59,75,16
263596,1396,299,59,72,13
253099,1537,332,59,73,14
243371,1497,332,59,71,12
258474,1492,336,59,59,0
261545,1459,310,59,68,9
241577,1567,345,59,71,12
241320,1522,333,59,59,0
223404,1435,315,59,59,0
213672,1554,335,59,60,1
262824,1584,342,59,70,11
257959,1412,300,59,68,9
257958,878,309,59,59,0
203430,1257,281,59,60,1
260772,1527,335,59,78,19
264247,1474,315,59,77,18
209324,1655,348,59,60,1
258477,1468,320,59,70,11
203504,1610,352,59,59,0
193713,1708,363,59,59,0
252342,845,312,59,69,10
261813,1560,328,59,73,14
260533,1424,314,59,71,12
224947,1089,340,59,69,10
257714,1535,325,59,66,7
240562,1571,337,59,73,14
262065,1509,333,59,69,10
236465,1515,318,59,68,9
252078,1432,309,59,71,12
253616,1510,328,59,67,8
235184,1396,295,59,62,3
263600,1541,330,59,69,10
263344,1381,296,59,69,10
261551,1561,339,59,70,11
261294,1012,327,59,71,12
253870,1586,342,59,59,0
246838,1497,334,59,68,9
264246,1566,327,59,75,16
245045,1323,291,59,70,11
264231,1612,339,59,70,11
259626,1384,315,59,73,14
253482,1598,333,59,75,16
260649,1583,340,59,59,0
263465,1555,332,59,69,10
261672,1527,333,59,66,7
263208,1539,329,59,68,9
260135,1436,308,59,73,14
263719,1446,319,59,69,10
261428,1435,304,59,75,16
262695,1536,330,59,68,9
230950,1573,348,59,66,7
220454,1396,302,59,59,0
256037,1393,305,59,70,11
264485,1596,336,59,68,9
248356,1505,327,59,79,20
245284,868,323,59,67,8
261418,1417,315,59,79,20
264235,1426,315,59,68,9
210987,1685,356,59,60,1
241963,1635,342,59,69,10
254260,1468,323,59,70,11
250931,1558,340,59,73,14
262706,1535,328,59,65,6
251439,1590,342,59,76,17
244014,1515,328,59,71,12
262702,1578,345,59,61,2
255789,1458,328,59,74,15
236845,1563,346,59,63,4
263469,1462,322,59,68,9
262957,1473,318,59,66,7
241964,1498,326,59,60,1
237612,1169,247,59,72,13
260651,1395,312,59,70,11
255531,1525,330,59,61,2
255275,1450,313,59,68,9
259766,1549,336,59,77,18
246711,1441,309,59,62,3
263608,1340,294,59,60,1
255460,1561,339,59,70,11
244965,1426,317,59,66,7
243173,1546,349,59,68,9
242661,1503,319,59,68,9
226021,1646,353,59,59,0
222181,1281,279,59,59,0
207589,1015,325,59,62,3
264165,1616,343,59,74,15
248548,1591,347,59,67,8
264673,1557,336,59,77,18
231396,1375,302,59,69,10
252387,1381,299,59,69,10
243427,1398,307,59,76,17
253153,1661,347,59,71,12
248545,871,323,59,70,11
242913,1416,300,59,64,5
242145,849,325,59,67,8
246757,1659,357,59,74,15
255205,1620,341,59,71,12
263654,1515,331,59,73,14
225766,1072,333,59,67,8
222191,1607,350,59,59,0
261102,1550,328,59,67,8
247022,838,316,59,67,8
263662,1626,346,59,68,9
255725,1429,322,59,71,12
257516,1412,301,59,69,10
236012,1646,346,59,66,7
228075,1200,336,59,64,5
264683,1469,322,59,75,16
241642,1382,297,59,66,7
251625,1517,325,59,69,10
245737,1445,322,59,65,6
264681,1487,325,59,72,13
255976,863,323,59,76,17
256743,1377,297,59,69,10
233441,1460,319,59,68,9
263649,1560,330,59,64,5
263353,1620,345,59,77,18
255419,1440,319,59,68,9
264129,1348,285,59,69,10
233408,1474,319,59,70,11
263872,840,322,59,69,10
261823,1577,335,59,71,12
263615,1427,315,59,68,9
257725,1466,316,59,65,6
263868,1351,281,59,69,10
242875,1559,336,59,59,0
111328,1076,319,59,59,0
233915,1474,323,59,66,7
228795,1512,322,59,59,0
261562,954,325,59,66,7
240570,1574,350,59,67,8
228794,1630,347,59,59,0
263354,1349,277,59,77,18
258489,1455,315,59,72,13
230081,1619,351,59,68,9
244673,1610,330,59,76,17
257217,1468,315,59,75,16
261569,1523,334,59,73,14
242911,1454,314,59,62,3
262367,1539,335,59,59,0
250846,1523,337,59,60,1
231646,1650,363,59,66,7
263134,1516,339,59,65,6
252125,1558,326,59,76,17
181725,1588,325,59,59,0
220893,1344,291,59,64,5
198109,1472,309,59,59,0
225756,1585,339,59,65,6
264156,1513,334,59,65,6
262363,1633,347,59,70,11
260570,1466,314,59,73,14
231735,1301,289,59,62,3
259639,1439,321,59,73,14
218593,1150,343,59,62,3
257071,1426,303,59,72,13
247057,1545,352,59,71,12
259080,1645,358,59,59,0
257550,910,323,59,62,3
244494,1471,315,59,72,13
235534,1566,328,59,70,11
227854,1422,308,59,67,8
259341,1452,306,59,73,14
263949,1570,341,59,75,16
262669,1541,329,59,68,9
262157,877,328,59,59,0
234508,1382,314,59,68,9
262923,1349,290,59,72,13
262922,845,316,59,70,11
260104,1651,349,59,67,8
260870,1457,318,59,72,13
263441,981,336,59,74,15
241414,1453,321,59,67,8
263686,1295,283,59,71,12
262662,1449,303,59,70,11
258053,1353,287,59,68,9
245509,1588,347,59,66,7
242436,1615,352,59,70,11
264196,1467,326,59,73,14
242435,1366,293,59,71,12
228610,1507,328,59,59,0
254465,1550,334,59,72,13
253440,1504,327,59,75,16
261376,992,325,59,66,7
253712,1558,350,59,72,13
248072,831,313,59,60,1
233745,1505,326,59,70,11
260888,1591,338,59,69,10
242961,1506,314,59,72,13
264222,1521,318,59,71,12
260893,1296,281,59,67,8
260892,1524,319,59,72,13
252700,1467,327,59,71,12
246300,1479,323,59,70,11
263707,1366,307,59,76,17
263451,1407,305,59,68,9
259866,1441,303,59,68,9
241434,1495,319,59,69,10
238105,1376,296,59,59,0
230940,1411,303,59,66,7
252439,1562,348,59,69,10
263444,1398,311,59,72,13
253713,1343,288,59,69,10
244498,945,320,59,60,1
257298,1425,309,59,65,6
254995,1481,316,59,74,15
248339,1528,326,59,62,3
211476,1566,344,59,59,0
261653,1394,300,59,68,9
259606,859,310,59,71,12
212759,1465,315,59,59,0
262466,1300,280,58,58,0
264520,1649,347,58,75,17
223298,1710,359,58,58,0
260418,1328,281,58,65,7
263750,1353,289,58,64,6
259398,1353,279,58,66,8
200263,1644,343,58,58,0
242759,1492,329,58,66,8
258377,1425,314,58,79,21
264521,1664,351,58,68,10
239689,856,302,58,67,9
263754,1632,357,58,71,13
246345,1249,265,58,72,14
261705,1374,303,58,68,10
261449,854,315,58,74,16
262977,1537,335,58,73,15
256321,1403,288,58,69,11
257082,925,324,58,65,7
262721,1545,330,58,72,14
182076,1071,337,58,58,0
258362,965,316,58,66,8
229450,1348,281,58,62,4
263227,1621,347,58,77,19
263995,1467,312,58,66,8
263996,1580,341,58,67,9
262970,1510,329,58,66,8
260924,1515,324,58,74,16
264512,1520,314,58,72,14
261948,1405,319,58,72,14
251453,869,311,58,75,17
259389,1402,306,58,73,15
262463,1037,321,58,58,0
260927,1474,312,58,75,17
264000,1324,282,58,68,10
264010,1460,312,58,76,18
258890,1540,337,58,73,15
257337,1524,325,58,61,3
251897,1550,337,58,74,16
264700,1433,303,58,72,14
263420,1350,279,58,68,10
252923,1620,346,58,72,14
228859,1536,333,58,67,9
263931,1454,318,58,72,14
263675,1439,304,58,65,7
248826,876,319,58,64,6
264186,1484,310,58,70,12
247289,846,301,58,65,7
238844,1476,315,58,68,10
262136,1392,304,58,70,12
255224,1414,289,58,69,11
264184,898,307,58,70,12
262135,1475,321,58,71,13
264182,898,326,58,68,10
262646,932,335,58,70,12
255989,940,318,58,69,11
243189,914,321,58,62,4
227836,1560,335,58,61,3
237309,1601,340,58,63,5
263668,1497,322,58,73,15
258313,1610,339,58,72,14
259083,1491,317,58,75,17
255755,1430,317,58,72,14
242955,1457,317,58,60,2
260362,906,307,58,63,5
256778,1524,331,58,74,16
227082,1640,347,58,61,3
259081,1539,324,58,77,19
258825,1426,308,58,68,10
247561,897,320,58,58,0
248317,1602,350,58,61,3
262665,1332,280,58,70,12
260616,1596,339,58,73,15
260863,1428,321,58,75,17
258047,1603,334,58,73,15
257791,964,310,58,72,14
245503,1397,302,58,70,12
250878,1483,330,58,66,8
260349,1015,325,58,58,0
264437,1308,275,58,73,15
262900,1419,311,58,70,12
262731,1348,287,58,71,13
243281,1324,274,58,69,11
261460,1394,316,58,75,17
252500,870,323,58,71,13
243540,1364,293,58,69,11
259922,1388,303,58,64,6
245074,829,296,58,63,5
234322,1411,307,58,60,2
263506,1597,350,58,66,8
261457,1538,330,58,70,12
260687,1392,312,58,70,12
236546,1473,316,58,65,7
243279,1521,326,58,68,10
261197,1284,285,58,67,9
246349,1412,308,58,76,18
264013,1495,324,58,58,0
246092,1560,334,58,72,14
259915,912,316,58,61,3
257099,1535,330,58,65,7
263755,1540,343,58,65,7
263936,1567,340,58,68,10
245506,1445,316,58,66,8
246259,1326,272,58,72,14
260848,1366,301,58,65,7
239859,1436,315,58,61,3
264691,1512,327,58,65,7
263155,1599,342,58,75,17
261618,1355,295,58,58,0
255474,1530,327,58,71,13
250865,880,322,58,72,14
243441,1348,288,58,60,2
241905,1379,299,58,67,9
261358,1460,329,58,76,18
263171,867,322,58,73,15
260078,1542,345,58,68,10
256750,1335,296,58,64,6
248814,1429,310,58,74,16
248328,1486,323,58,69,11
252422,1496,312,58,61,3
239621,1435,297,58,67,9
248836,1337,290,58,68,10
261379,1548,335,58,74,16
258617,1294,288,58,76,18
260528,1437,308,58,70,12
261687,918,320,58,65,7
251298,912,320,58,65,7
262818,1013,322,58,67,9
254113,1565,333,58,78,20
224673,1625,346,58,58,0
264097,1394,296,58,72,14
261280,1281,279,58,70,12
262816,1569,340,58,74,16
261535,1626,347,58,68,10
258462,1484,324,58,71,13
236702,1456,318,58,69,11
258973,1604,350,58,67,9
258717,1424,320,58,73,15
263581,1549,338,58,64,6
258460,1335,299,58,71,13
255644,1482,322,58,66,8
182428,1554,331,58,58,0
213148,1519,329,58,62,4
260507,1663,359,58,60,2
264091,1441,312,58,66,8
240794,1450,307,58,68,10
237722,1384,297,58,65,7
233882,1631,355,58,66,8
256152,1431,311,58,76,18
248472,1467,311,58,74,16
246168,1629,350,58,75,17
233368,1415,302,58,69,11
263576,862,321,58,77,19
193943,1654,348,58,58,0
264098,1360,291,58,73,15
264099,1433,317,58,70,12
254870,1400,309,58,71,13
237731,1519,331,58,68,10
237233,1581,328,58,60,2
260016,1431,307,58,77,19
252592,1551,331,58,69,11
251056,1025,327,58,64,6
240814,1399,301,58,66,8
244397,1463,309,58,77,19
263853,1697,362,58,66,8
260012,1084,333,58,72,14
258220,1346,288,58,70,12
261035,1448,310,58,76,18
260523,1549,332,58,76,18
255403,1406,310,58,72,14
225195,1428,303,58,59,1
221867,1580,347,58,63,5
263851,1218,331,58,75,17
240041,1562,331,58,67,9
228009,1581,344,58,59,1
264361,1414,311,58,75,17
263593,1340,290,58,65,7
262825,1576,337,58,69,11
237736,920,309,58,62,4
261542,1457,313,58,68,10
261030,1375,300,58,59,1
258982,1406,304,58,69,11
258470,1452,319,58,67,9
241318,1402,298,58,67,9
256164,1388,303,58,70,12
255639,1361,291,58,67,9
262806,1447,312,58,58,0
261430,1587,336,58,71,13
262845,1356,296,58,72,14
29118,1435,292,58,58,0
252862,1626,351,58,63,5
263871,1553,332,58,58,0
260031,1359,300,58,65,7
261567,1496,325,58,67,9
253120,1483,321,58,70,12
261824,1602,339,58,68,10
262593,1460,323,58,66,8
256449,1468,309,58,80,22
257473,1429,315,58,73,15
240580,1415,314,58,69,11
251332,876,310,58,70,12
191685,1048,331,58,58,0
195013,1486,312,58,58,0
241862,1358,287,58,69,11
262599,900,306,58,67,9
235975,1470,326,58,61,3
253383,1570,354,58,69,11
241864,1368,300,58,69,11
259272,1553,337,58,70,12
264649,1477,319,58,71,13
200393,1586,334,58,58,0
244937,1505,314,58,69,11
264650,1392,290,58,70,12
208842,1102,330,58,60,2
264460,816,315,58,73,15
257738,1609,326,58,58,0
225981,1047,329,58,63,5
261564,1500,318,58,73,15
260018,1126,340,58,73,15
251836,1396,315,58,68,10
262066,1438,323,58,69,11
263347,1501,322,58,68,10
264115,1469,307,58,75,17
231091,1539,330,58,58,0
254643,1526,317,58,65,7
255411,1569,335,58,73,15
256179,1507,332,58,72,14
260531,1373,302,58,66,8
264628,1427,309,58,78,20
246452,1439,309,58,66,8
257716,1376,316,58,66,8
255157,1509,331,58,71,13
262069,865,309,58,68,10
264118,1312,291,58,68,10
229046,1098,325,58,69,11
263095,1370,293,58,64,6
264631,1456,329,58,70,12
255671,1466,319,58,72,14
261815,1546,314,58,74,16
262071,1323,304,58,74,16
263352,1349,276,58,75,17
264120,1549,321,58,79,21
256696,1626,354,58,66,8
259257,915,312,58,72,14
255930,1644,342,58,65,7
256954,1557,334,58,70,12
255675,1516,322,58,71,13
262156,1456,315,58,72,14
241980,1572,335,58,69,11
260621,1357,295,58,63,5
251433,802,316,58,69,11
263458,1428,313,58,68,10
241954,1459,317,58,63,5
263971,1252,280,58,66,8
253475,1646,338,58,73,15
262692,1429,308,58,62,4
246052,1351,293,58,73,15
225061,1017,327,58,63,5
231461,1541,330,58,59,1
262694,1458,318,58,73,15
246054,1577,335,58,73,15
263207,1421,303,58,63,5
263463,1435,308,58,67,9
259111,1493,338,58,75,17
263210,1491,314,58,69,11
243917,863,314,58,67,9
263466,1328,287,58,73,15
264234,1569,335,58,74,16
226859,1644,354,58,65,7
259115,1668,355,58,66,8
259627,1456,317,58,70,12
240684,1410,305,58,64,6
236589,1569,340,58,70,12
256813,1333,292,58,71,13
257837,1468,333,58,73,15
258605,1474,327,58,68,10
230703,1337,285,58,65,7
241200,1502,324,58,66,8
264498,1474,323,58,68,10
261407,858,307,58,78,20
262687,990,328,58,63,5
260126,1376,300,58,77,19
259869,1560,342,58,71,13
264651,1481,324,58,80,22
258931,1605,344,58,75,17
259187,1349,289,58,72,14
256530,1479,309,58,70,12
261650,1454,322,58,65,7
263443,1379,300,58,72,14
264211,839,322,58,72,14
257299,1653,349,58,79,21
223764,1457,314,58,58,0
251924,1293,275,58,75,17
226837,1382,297,58,58,0
262678,1423,310,58,67,9
241687,1522,320,58,64,6
242199,1495,322,58,64,6
254999,1587,342,58,70,12
255767,1511,341,58,76,18
262424,952,330,58,60,2
262936,1463,314,58,76,18
246296,1340,284,58,78,20
259353,1523,329,58,67,9
221978,1505,320,58,58,0
259354,1341,294,58,65,7
242715,881,312,58,58,0
255003,1509,302,58,69,11
260891,1475,314,58,76,18
220188,1082,327,58,61,3
256028,1529,333,58,64,6
251796,1370,285,58,64,6
262671,1483,320,58,67,9
222003,1630,345,58,61,3
260483,1421,309,58,73,15
232838,1537,336,58,65,7
263303,1506,332,58,64,6
238983,1431,317,58,67,9
244615,1559,314,58,66,8
245127,1579,339,58,68,10
255367,1444,318,58,64,6
262536,1470,319,58,74,16
263306,1533,343,58,68,10
251018,1579,335,58,70,12
222348,1653,356,58,58,0
259724,1512,323,58,67,9
253069,921,326,58,58,0
258445,1393,306,58,70,12
2702,1662,337,58,58,0
252046,850,313,58,70,12
226191,1610,326,58,58,0
259215,1302,295,58,69,11
261007,1445,310,58,72,14
262288,1432,310,58,66,8
261520,1576,332,58,74,16
234641,1376,302,58,65,7
252305,1291,291,58,73,15
256401,1631,348,58,70,12
264338,1399,301,58,67,9
229779,1336,287,58,63,5
263316,919,312,58,84,26
263572,1413,298,58,74,16
259716,1553,336,58,70,12
221826,1664,355,58,58,0
233011,1429,308,58,65,7
261505,1402,301,58,77,19
262708,880,322,58,69,11
264565,1593,339,58,73,15
252534,1383,296,58,65,7
263799,1304,287,58,64,6
226423,1083,332,58,68,10
246647,1574,343,58,67,9
248183,1550,351,58,58,0
209528,1518,318,58,59,1
193912,990,301,58,58,0
242297,903,308,58,75,17
263546,1462,321,58,66,8
232314,1480,331,58,63,5
244090,896,322,58,68,10
263292,1559,337,58,76,18
263548,1297,285,58,68,10
255868,1389,313,58,75,17
262781,1328,295,58,67,9
263293,1503,321,58,77,19
247421,1457,320,58,69,11
253309,1419,314,58,71,13
257149,960,329,58,70,12
261245,1581,339,58,72,14
242047,1497,323,58,65,7
261247,1319,289,58,66,8
260736,1404,313,58,73,15
260992,1454,319,58,71,13
258689,1378,291,58,74,16
262349,1566,342,58,68,10
248340,1528,331,58,68,10
254925,1484,312,58,65,7
258906,1424,317,58,80,22
237402,1366,300,58,69,11
259673,1591,339,58,74,16
263001,1555,332,58,64,6
254552,1383,300,58,76,18
255831,1510,326,58,69,11
261462,1438,299,58,68,10
247894,873,301,58,68,10
222294,1688,363,58,58,0
264534,1581,338,58,71,13
240981,1563,341,58,65,7
198485,1325,284,58,58,0
261972,953,321,58,64,6
261085,1442,319,58,66,8
259292,1293,290,58,68,10
255964,887,315,58,71,13
237020,1494,324,58,65,7
263644,1410,312,58,66,8
264155,1452,316,58,65,7
256473,1296,282,58,70,12
240857,1549,337,58,67,9
264409,1406,318,58,70,12
259032,1672,359,58,75,17
258776,1432,317,58,74,16
261332,1530,334,58,69,11
258772,1414,309,58,67,9
240340,1569,337,58,64,6
247913,1498,328,58,67,9
245458,1455,322,58,66,8
238545,1367,300,58,72,14
182362,1641,332,58,58,0
239196,1504,336,58,65,7
191337,936,330,58,58,0
243292,1484,326,58,68,10
243813,1440,305,58,70,12
260301,1470,314,58,67,9
228198,1542,327,58,58,0
264551,1521,329,58,76,18
228199,1532,335,58,58,0
255335,1412,305,58,80,22
263272,853,314,58,76,18
261732,1424,323,58,75,17
248680,1526,328,58,76,18
261480,1333,283,58,71,13
255332,1586,337,58,65,7
252772,1416,310,58,64,6
264547,1472,309,58,80,22
258913,1276,279,58,73,15
229985,1328,278,58,65,7
262497,879,306,58,71,13
245088,954,325,58,63,5
262752,1441,314,58,74,16
259167,1306,284,58,67,9
199007,1020,330,58,58,0
260190,1417,316,58,65,7
255582,881,305,58,65,7
221790,1070,329,58,60,2
261469,1513,325,58,68,10
259677,1599,336,58,81,23
254813,1495,327,58,69,11
209757,1061,322,58,58,0
252252,1316,288,58,72,14
248668,1395,310,58,75,17
258000,1428,310,58,77,19
236252,920,316,58,64,6
263888,1541,354,58,74,16
264421,1458,311,58,77,19
236774,1525,342,58,63,5
246758,1586,341,58,70,12
251879,1559,335,58,68,10
262632,1500,316,58,76,18
262888,1456,311,58,72,14
247528,1433,313,58,72,14
251368,1527,336,58,69,11
251881,1285,281,58,73,15
255722,1380,304,58,72,14
260330,1030,329,58,67,9
263147,1480,323,58,77,19
207595,1467,295,58,58,0
238571,1044,329,58,66,8
261611,1434,304,58,67,9
248300,1547,342,58,61,3
255980,1554,331,58,70,12
239853,1213,267,58,63,5
255439,1315,298,58,72,14
253165,1433,306,58,76,18
248302,1467,322,58,58,0
248337,1520,328,58,69,11
264209,1570,332,58,81,23
254736,1603,348,58,61,3
251407,1589,323,58,75,17
233166,1446,314,58,68,10
255717,937,318,58,61,3
243949,1586,352,58,74,16
262885,1352,301,58,74,16
260465,1532,327,58,70,12
264399,1618,345,58,76,18
253412,1484,320,58,69,11
243818,1620,353,58,69,11
262764,895,323,58,58,0
256877,1359,293,58,72,14
263278,1465,317,58,58,0
243566,871,314,58,68,10
264560,1476,320,58,78,20
248688,1564,332,58,70,12
257392,959,315,58,71,13
264049,1613,337,58,75,17
242801,1373,301,58,69,11
263533,907,318,58,69,11
253410,886,326,58,70,12
262368,1623,337,58,58,0
258930,1395,294,58,75,17
245475,1508,319,58,67,9
244961,1397,304,58,70,12
263904,1492,326,58,67,9
240355,1346,299,58,66,8
257503,903,333,58,68,10
264415,933,316,58,76,18
253406,951,325,58,66,8
255091,1509,323,58,66,8
247201,1351,284,57,70,13
262555,1367,288,57,57,0
260511,1407,305,57,57,0
251039,1461,314,57,69,12
257438,1404,306,57,74,17
263069,1420,317,57,68,11
256924,910,330,57,68,11
247196,1534,326,57,57,0
261114,1377,304,57,66,9
243711,887,307,57,66,9
259993,1365,301,57,68,11
222361,1473,325,57,62,5
257175,1330,279,57,69,12
248319,1522,321,57,63,6
263423,840,303,57,72,15
258045,1353,301,57,67,10
255741,1352,291,57,62,5
206077,1390,303,57,57,0
261282,1415,312,57,73,16
242082,1429,328,57,63,6
251814,959,322,57,63,6
262563,1288,274,57,70,13
260525,966,313,57,63,6
263674,860,311,57,64,7
256934,1398,310,57,71,14
258214,1559,330,57,70,13
260775,1402,295,57,69,12
261544,875,307,57,67,10
260779,1381,304,57,69,12
263597,1438,304,57,70,13
255917,1462,303,57,71,14
256933,1529,332,57,74,17
262819,1458,318,57,66,9
251301,1539,322,57,74,17
240805,1543,345,57,67,10
239278,1544,338,57,64,7
261540,1286,273,57,68,11
254884,1549,341,57,72,15
240804,920,332,57,67,10
257699,1351,303,57,71,14
248227,1416,311,57,68,11
256506,1391,300,57,73,16
264685,1242,273,57,65,8
263162,1596,334,57,64,7
224866,1487,327,57,62,5
257893,1424,313,57,60,3
253285,1511,327,57,71,14
248164,1544,325,57,72,15
263524,877,306,57,65,8
252771,1438,302,57,66,9
242787,1609,338,57,73,16
263267,1410,309,57,58,1
260194,975,328,57,59,2
257890,1579,329,57,70,13
242786,1464,318,57,64,7
263010,841,322,57,65,8
252262,1596,335,57,65,8
257888,1509,315,57,71,14
264032,1262,271,57,66,9
245087,1567,349,57,64,7
264538,1430,305,57,74,17
256601,882,304,57,67,10
264537,1598,342,57,70,13
251224,1411,306,57,67,10
264536,1544,329,57,72,15
263767,1380,303,57,65,8
260438,1452,311,57,57,0
261989,1378,293,57,67,10
259430,884,315,57,78,21
264185,896,303,57,72,15
224619,1435,302,57,57,0
223091,1547,319,57,60,3
264563,1321,282,57,72,15
261234,889,304,57,69,12
238191,1348,298,57,65,8
261486,1370,295,57,71,14
263022,1222,261,57,71,14
247661,1540,329,57,68,11
258924,1362,299,57,65,8
252268,1411,301,57,70,13
174443,1483,327,57,57,0
263019,1418,298,57,64,7
264039,1396,301,57,76,19
262251,845,315,57,72,15
256874,1530,336,57,67,10
256106,1494,332,57,63,6
245866,868,312,57,67,10
244842,1490,315,57,71,14
261481,1452,312,57,69,12
264553,894,312,57,72,15
243048,915,321,57,70,13
264552,1607,341,57,69,12
261991,1602,338,57,71,14
259670,1567,331,57,66,9
252502,1471,315,57,70,13
259413,1399,310,57,71,14
256754,868,318,57,67,10
263918,1483,311,57,71,14
245743,1396,312,57,67,10
251375,1328,291,57,67,10
260079,1254,272,57,76,19
257776,1398,320,57,67,10
262385,1388,304,57,67,10
253169,875,307,57,65,8
264690,1504,334,57,65,8
227570,992,318,57,58,1
250866,1521,322,57,72,15
263667,932,303,57,64,7
252244,1510,314,57,58,1
264180,1579,329,57,82,25
258548,891,311,57,64,7
262901,1520,325,57,69,12
253429,1375,295,57,73,16
205558,1085,328,57,61,4
258806,1314,285,57,70,13
264183,891,311,57,70,13
245239,1583,338,57,72,15
255991,913,312,57,69,12
261623,1359,301,57,66,9
257005,1380,298,57,71,14
256749,1398,306,57,66,9
228077,1683,354,57,57,0
210925,1512,320,57,57,0
257619,1517,319,57,69,12
245075,1519,336,57,57,0
264275,1407,305,57,74,17
261201,1211,267,57,63,6
259808,1258,274,57,67,10
232673,943,312,57,60,3
256738,1335,295,57,63,6
258018,1572,338,57,71,14
260467,1446,327,57,73,16
248238,1487,331,57,65,8
240867,1398,310,57,70,13
255459,1499,334,57,65,8
257765,1542,328,57,67,10
261606,1296,274,57,61,4
247272,889,312,57,68,11
263658,1339,293,57,64,7
239594,867,322,57,71,14
253418,1479,310,57,67,10
261610,1298,288,57,66,9
234988,1571,332,57,63,6
259052,1361,314,57,71,14
246446,1670,352,57,70,13
260883,1472,315,57,69,12
251823,1406,302,57,68,11
232258,1460,327,57,57,0
260427,1529,327,57,66,9
247115,1521,326,57,72,15
255562,1436,304,57,71,14
247626,915,317,57,71,14
246090,1482,320,57,70,13
238410,1551,325,57,70,13
260425,1458,310,57,67,10
255049,1490,334,57,72,15
259399,1352,303,57,71,14
255815,1519,339,57,65,8
245574,1332,280,57,61,4
262470,1661,359,57,72,15
222277,1565,346,57,57,0
262725,1022,304,57,62,5
255811,868,317,57,71,14
262988,1517,320,57,76,19
200524,1562,329,57,57,0
262221,1429,305,57,74,17
248839,1406,307,57,68,11
234507,1551,326,57,57,0
262666,1442,309,57,68,11
261640,1363,296,57,78,21
256776,1452,315,57,66,9
253704,1482,324,57,65,8
258311,833,322,57,73,16
262919,1259,274,57,71,14
259917,1264,276,57,57,0
255493,1526,331,57,75,18
257617,1451,326,57,71,14
247121,882,302,57,62,5
256848,1439,318,57,74,17
234320,1409,317,57,62,5
262222,1418,309,57,72,15
263235,1603,342,57,74,17
253505,1524,331,57,66,9
254640,1316,287,57,71,14
242241,1442,324,57,69,12
241458,1512,323,57,67,10
237874,1544,331,57,68,11
235058,1521,330,57,62,5
263730,1494,315,57,64,7
260401,1490,327,57,73,16
236337,883,310,57,69,12
260911,1385,311,57,72,15
260399,1369,293,57,68,11
262447,1354,286,57,62,5
261166,1377,298,57,66,9
258604,1544,333,57,69,12
263468,1540,324,57,69,12
256555,1318,288,57,75,18
253227,1414,309,57,71,14
256884,1583,332,57,70,13
247347,1392,296,57,68,11
233524,1540,335,57,60,3
225845,977,319,57,67,10
263740,1354,299,57,65,8
255808,1468,315,57,65,8
253504,1546,317,57,57,0
252990,1469,315,57,66,9
261180,1488,317,57,69,12
256316,1354,305,57,68,11
264508,1336,294,57,70,13
232251,1504,317,57,62,5
243765,1363,297,57,72,15
264250,1309,284,57,73,16
259128,1377,310,57,64,7
263222,1414,298,57,72,15
252213,1324,287,57,69,12
246837,1314,283,57,71,14
245813,1423,307,57,68,11
246795,1533,322,57,65,8
262924,1501,321,57,70,13
140300,998,305,57,57,0
259340,1473,326,57,68,11
263612,1366,295,57,69,12
234940,1331,293,57,64,7
258748,1434,325,57,74,17
244925,1373,294,57,66,9
256701,1471,317,57,67,10
242730,1577,336,57,71,14
239146,1447,302,57,69,12
224554,1539,338,57,58,1
245033,1487,318,57,74,17
263720,1567,345,57,68,11
253479,1467,316,57,68,11
262951,1500,326,57,61,4
260645,1391,319,57,67,10
262181,1613,342,57,73,16
200484,1669,345,57,57,0
243130,904,327,57,71,14
264122,1315,287,57,66,9
238521,1433,302,57,66,9
258740,1398,308,57,59,2
245169,1521,329,57,65,8
246194,1347,302,57,69,12
254130,1482,310,57,71,14
258483,1548,333,57,68,11
241332,1549,332,57,65,8
252596,1298,281,57,70,13
231861,928,314,57,67,10
261304,1516,332,57,77,20
257717,1371,304,57,74,17
253110,867,302,57,69,12
255670,1420,309,57,66,9
243127,1553,331,57,63,6
255927,1492,307,57,70,13
233656,1494,326,57,60,3
230691,1441,308,57,60,3
259106,1520,329,57,57,0
247330,1407,317,57,69,12
264208,846,323,57,67,10
258581,1568,333,57,71,14
264213,1395,302,57,72,15
257300,1571,332,57,73,16
256532,1318,293,57,75,18
253971,1409,294,57,70,13
259346,1544,345,57,60,3
263184,1276,280,57,65,8
218646,1641,350,57,62,5
262928,1363,301,57,63,6
250895,1502,327,57,68,11
263951,1450,310,57,74,17
245518,1439,313,57,62,5
233742,902,308,57,63,6
263181,1195,256,57,71,14
264470,1387,295,57,69,12
226838,1123,335,57,57,0
252447,1297,262,57,62,5
244505,1411,309,57,68,11
257054,1349,305,57,67,10
254750,1351,294,57,75,18
260123,1317,289,57,71,14
247323,1204,262,57,64,7
263963,1400,303,57,67,10
252698,1356,299,57,70,13
232473,895,306,57,57,0
244502,1333,289,57,68,11
261912,1374,285,57,71,14
232216,1521,325,57,58,1
263192,1352,303,57,63,6
260887,1590,338,57,73,16
253207,1364,304,57,67,10
248855,1480,330,57,71,14
248180,1495,324,57,60,3
236005,844,310,57,65,8
264194,1500,314,57,77,20
260316,1012,341,57,64,7
263110,1294,287,57,68,11
183749,946,313,57,57,0
262341,1377,306,57,69,12
261828,1592,334,57,67,10
263619,879,315,57,74,17
261570,1413,301,57,68,11
254914,1517,319,57,67,10
232642,1343,301,57,66,9
262850,1374,304,57,66,9
261313,1399,299,57,68,11
222144,1632,340,57,57,0
262848,1475,312,57,68,11
250815,1517,329,57,68,11
243391,1526,329,57,72,15
241599,908,318,57,69,12
241343,1363,309,57,57,0
211135,1562,335,57,57,0
261822,1400,301,57,70,13
235710,1493,328,57,64,7
253955,1088,323,57,67,10
263684,1431,311,57,73,16
262661,1417,303,57,67,10
262917,1289,274,57,71,14
245765,1596,337,57,70,13
248325,917,319,57,60,3
252933,1285,284,57,67,10
262005,1348,297,57,70,13
247751,1242,330,57,69,12
255431,1444,307,57,65,8
263625,1414,301,57,68,11
261330,1408,308,57,70,13
248284,902,315,57,61,4
233948,1589,337,57,63,6
247259,1424,311,57,69,12
258522,1384,316,57,76,19
264410,1601,335,57,71,14
263130,1414,301,57,74,17
257496,1314,283,57,66,9
229080,1396,302,57,57,0
259543,1529,324,57,72,15
256215,1436,317,57,74,17
262615,1245,263,57,70,13
186838,1047,312,57,57,0
232402,1277,261,57,60,3
247241,1592,342,57,70,13
242385,1384,301,57,70,13
261583,1552,338,57,66,9
260559,1444,306,57,67,10
252879,1608,347,57,63,6
264398,1586,341,57,72,15
263886,1404,306,57,57,0
181964,1574,325,57,57,0
225740,1489,327,57,62,5
262604,1465,314,57,68,11
241098,1357,298,57,64,7
261577,832,303,57,67,10
255433,864,309,57,71,14
262774,1456,315,57,64,7
263798,836,300,57,71,14
257142,857,315,57,65,8
248464,1416,297,57,70,13
243845,1528,326,57,71,14
257926,893,313,57,66,9
199047,1476,304,57,57,0
243848,1323,282,57,74,17
258440,1468,323,57,68,11
258952,1454,311,57,62,5
262794,1479,324,57,65,8
263050,1322,280,57,69,12
257425,1094,345,57,64,7
237969,1358,297,57,65,8
263313,1400,310,57,64,7
262289,1554,334,57,72,15
257679,1264,275,57,71,14
232325,1519,331,57,66,9
234499,1375,296,57,66,9
262030,1464,316,57,62,5
259445,1369,294,57,68,11
258446,1402,296,57,73,16
256141,1369,283,57,66,9
252813,1423,301,57,71,14
243596,1602,339,57,66,9
264588,963,319,57,76,19
263052,1055,317,57,59,2
247179,1485,320,57,71,14
259722,1457,312,57,66,9
244362,897,317,57,65,8
238469,1505,323,57,65,8
263557,1320,292,57,66,9
193911,1076,333,57,57,0
243347,1334,291,57,71,14
261239,1280,285,57,65,8
260984,1454,307,57,77,20
264570,1522,332,57,74,17
260730,1419,301,57,76,19
238715,1389,310,57,71,14
243836,1301,284,57,74,17
254588,1302,279,57,78,21
257173,1380,306,57,65,8
262549,1437,317,57,71,14
261780,1427,315,57,64,7
246931,1417,299,57,66,9
244883,1440,318,57,64,7
258428,1434,316,57,70,13
262789,860,313,57,68,11
264573,1498,316,57,71,14
251261,1417,306,57,63,6
263038,1497,308,57,71,14
264574,1521,324,57,77,20
246142,1312,287,57,69,12
260734,1454,315,57,67,10
227970,1637,351,57,57,0
253314,1425,310,57,60,3
248707,1285,278,57,67,10
259203,1430,311,57,66,9
261507,1350,288,57,76,19
262276,1235,263,57,70,13
256220,874,309,57,67,10
263035,1384,308,57,72,15
254976,1530,329,57,69,12
238813,1544,336,57,66,9
259039,1366,313,57,72,15
222176,1077,333,57,58,1
222432,1680,345,57,57,0
251648,1568,329,57,71,14
251904,893,311,57,68,11
261120,1405,310,57,67,10
231681,938,320,57,64,7
241921,1442,308,57,66,9
260572,1405,305,57,73,16
232927,900,313,57,59,2
248798,1353,301,57,67,10
259805,1545,330,57,74,17
235742,1483,329,57,67,10
260228,1351,305,56,71,15
243582,1629,338,56,63,7
258688,874,306,56,64,8
263809,1515,326,56,74,18
256234,926,302,56,72,16
240769,1471,307,56,66,10
262530,863,309,56,63,7
264580,1411,304,56,68,12
252906,1377,303,56,66,10
263914,1269,265,56,68,12
263402,889,306,56,66,10
255209,1496,316,56,66,10
260584,1404,304,56,71,15
253672,890,320,56,65,9
194791,1582,329,56,56,0
251371,1562,321,56,63,7
247687,1177,263,56,59,3
252550,1418,311,56,70,14
261509,1299,277,56,78,22
248735,866,294,56,63,7
248294,1467,318,56,63,7
260510,1366,296,56,70,14
261867,904,304,56,62,6
238205,1303,267,56,56,0
247033,844,311,56,66,10
264441,1435,318,56,67,11
226296,1668,344,56,57,1
263160,1440,311,56,58,2
260855,1458,302,56,72,16
183031,1195,329,56,56,0
239607,1667,358,56,62,6
251124,1441,306,56,69,13
243188,1365,301,56,68,12
248307,1398,308,56,65,9
263922,801,298,56,68,12
243696,1471,320,56,69,13
222192,1566,336,56,57,1
260847,943,311,56,63,7
212719,1017,318,56,61,5
260845,1337,291,56,72,16
257517,967,319,56,74,18
257261,1467,319,56,69,13
261612,1485,311,56,65,9
242558,1413,302,56,65,9
221815,1353,299,56,56,0
262266,806,301,56,67,11
264293,1482,316,56,77,21
258410,1416,310,56,59,3
255337,1479,317,56,72,16
253801,1418,313,56,67,11
260967,972,307,56,72,16
253031,1525,331,56,56,0
260710,1345,287,56,66,10
255846,1400,303,56,66,10
262246,1364,303,56,67,11
261477,1275,269,56,68,12
255843,1516,342,56,70,14
251001,1553,330,56,66,10
263778,1308,275,56,72,16
252257,846,308,56,66,10
259168,893,311,56,68,12
261471,1486,327,56,71,15
259678,918,300,56,74,18
264286,1467,310,56,64,8
256861,1343,290,56,69,13
244828,901,308,56,61,5
264284,1298,277,56,64,8
261994,1337,285,56,63,7
252011,1562,343,56,70,14
224620,1684,355,56,56,0
258668,1347,300,56,71,15
263033,877,319,56,69,13
261240,1427,318,56,60,4
257912,1445,304,56,70,14
258297,1373,295,56,72,16
258421,1428,315,56,72,16
254324,1426,303,56,71,15
264564,1366,290,56,76,20
260979,1463,311,56,75,19
255347,1496,317,56,63,7
264051,1380,305,56,73,17
262002,1435,306,56,78,22
261490,1395,298,56,77,21
253041,1483,316,56,65,9
246129,1606,338,56,72,16
263025,1446,312,56,69,13
263024,1417,307,56,69,13
261487,1386,300,56,67,11
263023,842,302,56,69,13
254574,1232,274,56,72,16
248313,1285,281,56,56,0
252167,1379,291,56,64,8
259577,1520,319,56,64,8
241360,1441,321,56,65,9
260395,1578,334,56,64,8
243667,1353,300,56,69,13
264659,1520,328,56,68,12
248274,1436,310,56,64,8
263890,1263,274,56,68,12
262354,1472,313,56,61,5
258001,1389,304,56,74,18
263889,912,297,56,70,14
259792,1487,320,56,67,11
264655,1358,291,56,64,8
262342,1324,286,56,65,9
264143,1399,308,56,69,13
262606,1462,314,56,67,11
263629,993,338,56,70,14
264396,1376,301,56,70,14
253387,1313,289,56,62,6
263626,1349,284,56,64,8
256713,1469,311,56,75,19
244425,1545,319,56,67,11
261574,1512,324,56,71,15
229931,1380,293,56,64,8
252970,1456,306,56,69,13
245034,1421,305,56,65,9
233770,1554,330,56,63,7
259870,1438,312,56,67,11
213535,1055,320,56,56,0
240927,1523,328,56,66,10
260383,1361,302,56,68,12
219936,1093,315,56,56,0
263713,1411,309,56,73,17
261410,1526,327,56,73,17
262179,1405,312,56,68,12
259619,1397,304,56,72,16
263460,1362,285,56,67,11
253476,1484,329,56,66,10
263461,1303,273,56,65,9
247077,881,301,56,70,14
224550,1322,296,56,60,4
255014,894,312,56,62,6
261158,1308,289,56,77,21
254503,1369,301,56,74,18
253736,1533,322,56,73,17
262697,1443,305,56,66,10
240838,1122,331,56,70,14
260805,1405,299,56,65,9
240890,1487,323,56,63,7
228784,1386,298,56,63,7
264117,1416,309,56,72,16
263093,1454,311,56,66,10
261300,1505,319,56,68,12
259508,1384,302,56,62,6
261298,1609,350,56,62,6
259250,1570,332,56,73,17
253106,1396,304,56,74,18
243890,1490,318,56,66,10
260272,1483,326,56,75,19
262576,1338,292,56,66,10
261315,1438,309,56,66,10
263599,1399,295,56,67,11
261038,1368,305,56,69,13
262830,867,304,56,63,7
258820,1420,310,56,75,19
263685,1246,273,56,71,15
259078,1525,322,56,74,18
243546,1579,335,56,67,11
256263,1545,324,56,73,17
242682,1493,326,56,66,10
239798,898,306,56,66,10
263351,1405,303,56,64,8
264375,1399,308,56,68,12
255159,942,324,56,63,7
239811,803,299,56,65,9
261314,1471,311,56,73,17
260802,1403,297,56,62,6
259266,1553,327,56,70,14
254658,1446,306,56,69,13
248770,1408,306,56,70,14
262080,999,329,56,65,9
253374,1558,338,56,69,13
241342,1455,307,56,56,0
263870,1543,331,56,64,8
263357,1363,295,56,69,13
263356,1465,315,56,71,15
243387,883,306,56,70,14
263611,1399,298,56,72,16
242874,1435,313,56,63,7
263610,1439,307,56,69,13
258745,1559,330,56,67,11
262328,1415,294,56,63,7
256951,1485,316,56,59,3
247898,1426,310,56,64,8
260484,1416,286,56,70,14
263142,1325,293,56,64,8
263984,1370,294,56,72,16
242994,1646,340,56,69,13
263987,1376,301,56,64,8
257944,1401,309,56,67,11
245043,1391,302,56,71,15
263476,1233,263,56,65,9
233525,1485,319,56,64,8
246681,1554,332,56,69,13
248473,1472,314,56,73,17
255130,1504,320,56,65,9
263580,1422,318,56,71,15
263836,1311,277,56,70,14
261276,1488,322,56,70,14
257508,1366,294,56,75,19
244279,1506,324,56,62,6
253496,1467,325,56,72,16
264505,1441,309,56,68,12
166713,1104,311,56,56,0
258873,1570,340,56,64,8
254522,1257,262,56,70,14
248380,1558,326,56,65,9
246333,1371,292,56,70,14
260913,839,296,56,71,15
261679,916,310,56,74,18
261693,1306,281,56,68,12
263983,1261,265,56,73,17
238487,1408,313,56,67,11
247448,844,300,56,59,3
261027,872,310,56,59,3
263076,1471,317,56,71,15
246693,1433,304,56,65,9
261029,1332,283,56,61,5
263334,1381,284,56,67,11
245160,1409,303,56,73,17
261288,1556,334,56,64,8
257193,1473,312,56,70,14
252480,1436,305,56,72,16
238250,1194,250,56,56,0
254122,842,304,56,71,15
255658,1389,300,56,59,3
243373,853,295,56,66,10
262444,1393,303,56,62,6
234796,841,305,56,62,6
260396,1392,295,56,73,17
250925,971,309,56,66,10
241454,1385,307,56,69,13
258606,1360,298,56,66,10
259645,1517,331,56,58,2
262206,1511,332,56,70,14
261526,1324,289,56,76,20
244306,1307,286,56,67,11
255824,1238,265,56,69,13
262223,1429,303,56,69,13
261454,1313,277,56,65,9
250958,1474,315,56,65,9
257869,1352,284,56,64,8
252748,1476,323,56,70,14
251980,1417,300,56,71,15
247627,1556,335,56,56,0
234571,1435,313,56,65,9
255817,1432,307,56,68,12
255559,1375,297,56,66,10
244294,1556,333,56,66,10
242246,1412,300,56,65,9
242245,1492,322,56,62,6
198469,1617,324,56,56,0
261700,1373,305,56,64,8
254276,933,324,56,72,16
253508,1485,326,56,70,14
261698,1346,293,56,70,14
262722,1275,276,56,66,10
255809,1353,297,56,68,12
243025,1283,277,56,71,15
251218,929,310,56,63,7
222014,1544,328,56,56,0
239444,1584,326,56,62,6
253758,1459,318,56,71,15
262719,1511,328,56,64,8
228253,1014,319,56,59,3
262045,1416,290,56,76,20
243102,1449,313,56,69,13
253726,1394,301,56,63,7
262941,1563,347,56,71,15
255260,1311,278,56,62,6
245531,1587,344,56,67,11
262939,866,299,56,72,16
261656,1012,301,56,58,2
248856,1537,326,56,72,16
256534,1240,267,56,72,16
248597,893,302,56,66,10
182037,1557,309,56,56,0
263445,1338,285,56,66,10
253972,1328,293,56,70,14
244056,1297,287,56,71,15
257367,1412,312,56,68,12
229206,1440,310,56,62,6
259924,1379,302,56,71,15
264343,1412,305,56,73,17
259753,1389,295,56,77,21
239510,926,311,56,61,5
257932,1374,301,56,68,12
262420,924,321,56,75,19
264212,1526,325,56,64,8
248711,1317,279,56,73,17
256135,1299,291,56,63,7
260743,841,299,56,74,18
258696,1452,299,56,56,0
261001,1472,316,56,67,11
257163,1396,309,56,74,18
259723,1327,290,56,68,12
256396,1309,292,56,70,14
217231,1006,319,56,56,0
243730,1548,333,56,63,7
261775,1452,317,56,67,11
260496,1400,313,56,57,1
263569,809,310,56,66,10
226450,1049,318,56,61,5
263315,817,303,56,71,15
251283,1474,315,56,68,12
257427,1549,329,56,61,5
257428,1451,301,56,72,16
231172,959,307,56,63,7
254467,1271,265,56,67,11
257554,1433,319,56,69,13
260881,1548,326,56,61,5
258050,1432,311,56,68,12
262921,1403,298,56,69,13
248292,962,317,56,70,14
262371,1308,285,56,56,0
234978,1541,320,56,65,9
102881,1018,302,56,56,0
261344,848,303,56,72,16
263392,1486,319,56,65,9
261342,1343,292,56,73,17
260829,868,298,56,62,6
259549,1086,326,56,71,15
258056,996,322,56,74,18
264458,1356,317,56,71,15
243728,1395,299,56,71,15
241418,1599,341,56,62,6
262668,1284,276,56,70,14
263948,1382,297,56,65,9
242700,1386,290,56,56,0
251660,1502,323,56,56,0
255756,1482,328,56,70,14
263437,1472,319,56,70,14
264461,1434,309,56,69,13
247821,1535,324,56,72,16
203023,1490,317,56,56,0
216214,1351,292,56,57,1
253760,1418,302,56,60,4
264666,1523,320,56,70,14
247000,1409,306,56,61,5
259988,897,307,56,61,5
261331,1348,288,56,73,17
263892,1398,309,56,75,19
263381,1410,302,56,75,19
232149,929,300,56,62,6
262101,1347,277,56,69,13
263382,1447,311,56,76,20
259288,1422,306,56,67,11
260859,1413,313,56,70,14
233945,1516,333,56,60,4
253401,1422,313,56,67,11
264411,1320,281,56,76,20
262364,1230,275,56,60,4
264668,855,304,56,66,10
263419,1390,305,56,66,10
264443,1348,302,56,64,8
263426,1480,319,56,71,15
256513,1538,326,56,69,13
264352,1413,305,56,75,19
261525,1322,292,56,76,20
252835,1306,296,56,68,12
213923,1501,319,56,59,3
231682,847,312,56,63,7
258721,1445,297,56,70,14
256417,1473,310,56,63,7
244129,1273,277,56,67,11
264342,1443,306,56,70,14
257019,1366,297,56,69,13
259989,1403,306,56,65,9
248469,1320,292,56,75,19
260350,954,318,56,70,14
258302,1500,320,56,70,14
238076,1075,316,56,58,2
230759,1464,307,55,63,8
244583,824,298,55,69,14
255842,1276,284,55,69,14
262755,1367,302,55,65,10
261731,878,291,55,70,15
256353,1326,295,55,74,19
262244,1347,299,55,72,17
262756,1361,304,55,67,12
257892,815,305,55,73,18
264294,1396,309,55,76,21
245090,861,310,55,65,10
257138,813,284,55,72,17
259174,1509,325,55,61,6
247656,821,301,55,69,14
256375,1428,310,55,56,1
257400,1523,326,55,74,19
235897,1377,290,55,58,3
262522,1382,301,55,67,12
248187,1330,292,55,71,16
251771,831,296,55,65,10
256380,1500,324,55,70,15
264306,1368,289,55,69,14
261501,1367,295,55,58,3
246654,1351,291,55,70,15
255870,1503,322,55,64,9
258929,1360,293,55,72,17
258928,841,302,55,70,15
256110,1506,328,55,63,8
254830,849,303,55,65,10
263277,1480,327,55,64,9
256620,1511,321,55,73,18
256108,862,300,55,67,12
250988,1408,301,55,55,0
257641,1390,301,55,63,8
248694,1509,314,55,65,10
256617,1243,261,55,68,13
255849,882,292,55,65,10
228989,1426,311,55,55,0
264083,1442,310,55,70,15
259455,1502,314,55,58,3
243273,1383,298,55,65,10
251819,1316,293,55,68,13
261032,1538,322,55,72,17
257192,1558,342,55,71,16
247371,1399,302,55,67,12
263243,1296,284,55,70,15
260169,901,305,55,73,18
251465,949,320,55,64,9
244553,829,298,55,67,12
229193,1046,323,55,55,0
262059,851,294,55,63,8
264009,1359,294,55,63,8
262729,1321,295,55,68,13
254792,938,311,55,63,8
256070,1370,291,55,63,8
247622,1470,315,55,67,12
258373,1323,292,55,69,14
261543,1335,295,55,58,3
247719,1503,325,55,60,5
256683,1272,283,55,69,14
245420,1399,308,55,62,7
261286,1407,303,55,63,8
263251,1333,289,55,69,14
263777,1348,295,55,67,12
263244,1370,302,55,71,16
259149,820,291,55,70,15
260175,1389,292,55,74,19
262224,1495,320,55,72,17
259920,1460,319,55,56,1
247889,1316,303,55,72,17
262995,852,301,55,67,12
263507,1325,288,55,65,10
243117,1403,307,55,59,4
263859,1461,308,55,73,18
252850,1444,310,55,72,17
262322,883,303,55,72,17
255921,824,305,55,63,8
264112,892,317,55,71,16
245167,1467,318,55,58,3
256174,1380,303,55,73,18
261293,1357,292,55,76,21
263335,1268,271,55,74,19
264358,1222,266,55,62,7
262275,1357,304,55,66,11
217992,1581,326,55,58,3
248203,1514,328,55,70,15
262539,1401,292,55,73,18
253066,1374,297,55,60,5
247434,932,311,55,59,4
241033,1011,315,55,67,12
256392,1335,292,55,71,16
253064,1499,332,55,65,10
242056,1501,325,55,65,10
260486,1503,315,55,72,17
263057,906,285,55,76,21
257158,1406,300,55,65,10
240518,1359,283,55,60,5
263302,1532,335,55,68,13
257157,1432,303,55,72,17
252549,1427,309,55,68,13
248197,1449,318,55,63,8
264069,1312,283,55,65,10
263301,838,299,55,69,14
231567,1517,318,55,55,0
252306,1284,281,55,69,14
262310,1512,328,55,68,13
252061,1563,329,55,67,12
261285,1176,257,55,55,0
248741,888,306,55,71,16
236453,1530,330,55,62,7
263333,1554,329,55,65,10
258724,1563,332,55,74,19
247715,1456,312,55,65,10
263842,1464,315,55,67,12
263073,1337,290,55,66,11
257435,1453,311,55,73,18
253078,1460,304,55,66,11
241307,1480,326,55,55,0
245146,1300,292,55,69,14
234393,1404,307,55,64,9
260503,1349,295,55,64,9
258711,1535,322,55,55,0
237975,1460,315,55,65,10
263831,1542,332,55,65,10
263575,1251,264,55,73,18
248673,1392,308,55,69,14
264138,881,306,55,71,16
256864,1366,297,55,71,16
264440,1416,311,55,69,14
263152,1348,298,55,60,5
257264,1294,287,55,69,14
244465,1326,290,55,67,12
252659,887,301,55,63,8
260852,1394,303,55,69,14
263157,1330,289,55,77,22
248310,1472,320,55,56,1
255990,1611,341,55,61,6
264695,1263,271,55,70,15
261727,1425,304,55,65,10
263417,1311,276,55,63,8
248251,1554,338,55,63,8
254713,1423,304,55,68,13
257787,1537,336,55,69,14
248830,885,297,55,67,12
251390,1352,282,55,69,14
261118,1387,288,55,66,11
264191,1334,287,55,66,11
264703,1489,322,55,68,13
263424,1505,325,55,67,12
252160,798,295,55,69,14
264193,1352,290,55,69,14
260846,1531,317,55,70,15
261869,1288,275,55,65,10
261099,1473,310,55,70,15
254699,1340,290,55,71,16
239803,1509,331,55,63,8
264379,1368,299,55,72,17
248250,1352,297,55,55,0
264634,1488,320,55,66,11
262841,1376,300,55,71,16
242872,1313,295,55,55,0
248246,847,290,55,55,0
262837,890,303,55,67,12
250804,1090,344,55,72,17
263348,1338,294,55,65,10
264371,1369,300,55,71,16
263652,1264,270,55,68,13
250853,1517,323,55,69,14
244966,1520,317,55,62,7
258023,1414,307,55,69,14
240104,1377,293,55,69,14
260585,1206,266,55,58,3
231146,915,313,55,61,6
261098,1451,307,55,72,17
263403,1386,300,55,69,14
233451,1594,340,55,55,0
256514,1432,310,55,74,19
258562,1329,300,55,73,18
262916,1431,322,55,73,18
260885,1399,308,55,67,12
263702,1319,291,55,63,8
260375,1385,309,55,66,11
263961,865,312,55,75,20
260633,1426,301,55,63,8
264474,1559,326,55,66,11
253722,1519,327,55,64,9
246043,1497,324,55,61,6
260379,1492,321,55,72,17
221980,1391,299,55,55,0
255004,848,308,55,59,4
243485,1393,301,55,66,11
257053,1340,290,55,66,11
235806,832,286,55,65,10
262175,1479,313,55,72,17
263969,1357,295,55,67,12
233505,955,315,55,65,10
263459,1374,299,55,69,14
208932,1056,314,55,55,0
252709,1441,310,55,67,12
264486,1440,312,55,60,5
252198,1314,286,55,70,15
263446,1412,302,55,69,14
260373,1376,289,55,64,9
253700,1543,327,55,55,0
259348,1439,308,55,57,2
257028,1295,282,55,65,10
260612,1391,299,55,70,15
248327,1418,314,55,62,7
262920,1180,256,55,72,17
261384,1453,332,55,69,14
258569,1446,310,55,74,19
258828,1565,334,55,70,15
264205,1395,299,55,73,18
248334,1403,305,55,56,1
257294,1319,291,55,63,8
240400,1385,299,55,64,9
248592,1332,303,55,69,14
250897,833,297,55,63,8
256529,869,295,55,65,10
247058,851,303,55,71,16
256786,1328,290,55,70,15
260882,1509,328,55,65,10
246291,1374,291,55,71,16
252435,1441,308,55,75,20
256787,1531,309,55,66,11
254740,1349,305,55,69,14
246715,1443,316,55,63,8
259319,1200,263,55,66,11
250811,1260,280,55,69,14
261459,1412,306,55,75,20
241471,1422,307,55,60,5
241983,1402,299,55,72,17
246849,1534,333,55,62,7
260929,1554,327,55,73,18
247874,1357,291,55,76,21
263747,1274,281,55,72,17
264003,1211,265,55,64,9
254275,1310,282,55,71,16
263236,1479,318,55,66,11
263492,1277,276,55,72,17
263748,1341,288,55,76,21
264277,1286,278,55,71,16
261420,1372,297,55,73,18
261973,1227,253,55,62,7
248406,1473,316,55,71,16
245847,1300,288,55,69,14
252505,894,304,55,68,13
247899,1379,292,55,68,13
254811,886,295,55,72,17
261467,871,297,55,67,12
257628,1234,269,55,70,15
260700,884,303,55,67,12
252253,1370,301,55,64,9
256606,1294,273,55,72,17
259644,1504,335,55,66,11
256060,1389,305,55,55,0
264252,1382,295,55,69,14
261819,1535,315,55,69,14
236328,1401,312,55,64,9
263464,1443,311,55,69,14
256551,1333,290,55,69,14
259622,822,300,55,63,8
263140,1371,302,55,58,3
256557,853,289,55,69,14
262960,1425,316,55,69,14
245040,1502,334,55,67,12
262450,1579,347,55,68,13
264242,838,307,55,71,16
243506,1371,299,55,62,7
254002,1624,350,55,68,13
257842,1419,312,55,72,17
263731,1477,312,55,67,12
259379,1401,297,55,62,7
261683,1432,308,55,63,8
261684,1438,309,55,68,13
253749,1373,302,55,60,5
254518,1544,327,55,69,14
262967,1333,270,55,64,9
261688,1431,303,55,65,10
211258,1021,320,55,55,0
257339,1314,281,55,74,19
264287,1552,324,55,71,16
253483,1270,273,55,73,18
259542,1307,276,55,77,22
257490,1537,347,55,68,13
233689,944,294,55,63,8
239320,853,301,55,65,10
257495,1406,309,55,70,15
263895,1422,304,55,68,13
257991,1431,308,55,70,15
247766,1437,316,55,65,10
262614,1452,320,55,65,10
258004,1375,304,55,68,13
263632,1267,265,55,65,10
263388,1385,301,55,69,14
263887,881,309,55,75,20
257742,895,305,55,59,4
257997,1300,280,55,70,15
250829,1290,271,55,68,13
264653,854,293,55,69,14
258508,1346,294,55,70,15
257996,866,298,55,74,19
263371,1509,325,55,64,9
264154,1225,260,55,64,9
258780,888,301,55,65,10
264137,1508,322,55,70,15
260548,806,287,55,70,15
248252,1483,319,55,55,0
258237,1415,304,55,72,17
258749,1411,311,55,75,20
138431,1025,325,55,55,0
260544,1357,302,55,66,11
260545,1452,322,55,72,17
262851,1398,299,55,68,13
257475,1073,300,55,63,8
261573,1233,266,55,70,15
263902,994,320,55,66,11
263395,1546,324,55,71,16
258530,1422,301,55,70,15
240866,1391,298,55,69,14
248289,1450,317,55,58,3
240609,1414,301,55,66,11
261088,1398,308,55,73,18
263391,1549,323,55,64,9
243166,1550,335,55,68,13
258249,1299,278,55,65,10
241401,879,295,54,62,8
222200,1177,255,54,54,0
261375,862,300,54,74,20
263679,1362,289,54,76,22
263934,1353,291,54,72,18
258813,1370,300,54,73,19
257788,1353,287,54,72,18
264444,1426,315,54,68,14
259834,1466,318,54,66,12
257529,1374,286,54,68,14
248569,1339,288,54,73,19
260853,1421,308,54,70,16
260856,1440,310,54,72,18
233681,1044,299,54,62,8
263364,1378,300,54,74,20
264644,1383,296,54,69,15
248290,1491,323,54,61,7
256482,1277,276,54,67,13
248291,860,294,54,54,0
258532,1388,294,54,69,15
261604,1409,309,54,64,10
263397,1350,293,54,74,20
248293,1287,275,54,55,1
263656,1350,287,54,73,19
264168,1388,292,54,72,18
244712,863,289,54,63,9
250856,1544,330,54,67,13
255208,872,312,54,66,12
222185,1516,317,54,57,3
258793,1528,325,54,65,11
261353,1385,305,54,73,19
262379,1318,296,54,70,16
234477,1316,273,54,63,9
248301,884,296,54,60,6
262640,1419,306,54,74,20
248304,1365,298,54,59,5
256497,1479,314,54,61,7
263666,1492,312,54,64,10
254962,816,289,54,63,9
260851,1299,274,54,69,15
261108,1510,336,54,75,21
229365,1427,312,54,61,7
245493,1303,279,54,61,7
257249,1477,319,54,65,11
263137,802,286,54,67,13
256221,1452,313,54,68,14
257741,860,294,54,61,7
261572,1289,263,54,64,10
263621,1445,302,54,76,22
257221,1385,306,54,66,12
263622,1312,285,54,69,15
242630,1313,281,54,60,6
251590,1478,312,54,74,20
256200,1330,284,54,73,19
258248,822,291,54,66,12
258761,1389,304,54,72,18
260809,1354,302,54,63,9
255178,830,292,54,64,10
262860,1357,296,54,72,18
244943,828,292,54,70,16
222173,1531,328,54,54,0
259279,850,295,54,68,14
240592,889,289,54,66,12
260305,862,290,54,65,11
261585,1327,287,54,69,15
240339,832,289,54,63,9
253395,1331,284,54,69,15
264661,1263,271,54,63,9
263894,1399,293,54,70,16
243158,808,294,54,66,12
248280,1449,302,54,57,3
252888,1508,331,54,69,15
245467,856,302,54,64,10
224650,1386,295,54,54,0
263706,809,302,54,74,20
258622,1567,330,54,69,15
262182,1233,266,54,62,8
262948,1459,320,54,68,14
256034,841,296,54,74,20
263714,1409,297,54,74,20
264224,1374,295,54,71,17
263968,1237,273,54,76,22
224287,1397,306,54,57,3
264479,1279,276,54,71,17
263967,861,289,54,67,13
262174,1361,292,54,70,16
256029,1386,295,54,74,20
263453,1492,316,54,68,14
260380,1256,276,54,69,15
261915,1245,270,54,58,4
261658,966,308,54,65,11
263186,1377,303,54,68,14
258839,1328,282,54,65,11
253461,1524,311,54,74,20
252180,1332,291,54,72,18
258835,1433,312,54,67,13
262931,912,290,54,75,21
262163,1389,303,54,65,11
242706,1265,275,54,73,19
248172,1290,278,54,54,0
263276,1298,289,54,65,11
258411,1358,301,54,61,7
263716,1392,300,54,67,13
263974,1414,318,54,69,15
260698,1477,321,54,68,14
253478,1423,311,54,64,10
243517,1321,292,54,72,18
258363,1249,270,54,68,14
248379,1398,295,54,65,11
260154,826,291,54,73,19
262968,1399,317,54,74,20
259895,1474,318,54,66,12
256054,1493,338,54,71,17
198454,1568,328,54,54,0
264501,1302,286,54,69,15
256563,1387,292,54,70,16
262707,912,311,54,72,18
233264,912,295,54,65,11
257326,1362,295,54,68,14
262700,1447,313,54,65,11
261931,882,291,54,60,6
256043,1375,298,54,67,13
260394,1466,311,54,63,9
259370,850,297,54,70,16
257065,1347,288,54,69,15
256553,1450,317,54,68,14
261159,873,299,54,72,18
256039,1393,293,54,74,20
242983,901,310,54,66,12
260390,1511,329,54,73,19
258342,1356,298,54,68,14
260714,879,293,54,64,10
264040,1441,316,54,73,19
257894,1390,300,54,55,1
228196,1445,312,54,54,0
263856,1378,295,54,68,14
241327,905,294,54,63,9
248494,1370,294,54,70,16
263854,1325,288,54,70,16
243012,793,287,54,67,13
260164,1399,300,54,68,14
264005,1363,293,54,71,17
217157,1497,320,54,54,0
255814,1467,319,54,70,16
264264,1339,293,54,70,16
261448,1405,297,54,66,12
261450,1487,322,54,63,9
240460,859,286,54,59,5
257100,881,300,54,74,20
262733,1515,315,54,76,22
263245,1327,286,54,72,18
250957,905,298,54,67,13
253518,1252,274,54,63,9
261968,884,300,54,68,14
263508,1394,302,54,74,20
252246,1417,306,54,64,10
262999,830,294,54,66,12
261975,1343,280,54,54,0
264281,1517,324,54,70,16
212057,1453,312,54,55,1
248752,1503,325,54,62,8
263345,1219,260,54,70,16
245425,853,294,54,67,13
241338,1307,283,54,57,3
243299,842,296,54,58,4
256866,1505,325,54,70,16
208482,1323,286,54,54,0
263266,1432,308,54,64,10
248158,915,313,54,74,20
213854,1428,297,54,54,0
264643,790,279,54,62,8
257984,1473,320,54,70,16
259518,1320,278,54,68,14
263101,1337,282,54,71,17
260539,1274,281,54,68,14
263425,1469,309,54,66,12
248242,1253,269,54,63,9
252161,1225,264,54,63,9
257793,1358,294,54,76,22
263938,1418,304,54,69,15
252418,1247,269,54,69,15
241593,1530,336,54,57,3
251832,1302,281,54,63,9
241592,1362,296,54,64,10
262327,1369,291,54,74,20
252597,1328,295,54,73,19
257972,1504,330,54,72,18
245427,1343,282,54,57,3
252733,1342,292,54,62,8
263770,1392,301,54,71,17
262207,1361,301,54,69,15
251789,874,306,54,58,4
254978,858,299,54,64,10
258703,1367,295,54,70,16
262032,1361,297,54,62,8
258449,1438,311,54,64,10
262802,845,302,54,60,6
264082,1488,313,54,64,10
263317,1460,310,54,69,15
263830,1295,285,54,66,12
262807,850,286,54,66,12
241303,1541,326,54,54,0
258623,1410,299,54,68,14
263577,1182,253,54,70,16
263833,1391,288,54,72,18
258969,1494,325,54,71,17
251546,1283,279,54,71,17
259741,1460,318,54,58,4
259997,1336,289,54,62,8
262048,1387,302,54,63,9
263841,1403,303,54,69,15
243342,1522,324,54,68,14
253068,1479,314,54,65,11
260003,1211,269,54,71,17
263939,1440,313,54,72,18
259089,837,291,54,64,10
259343,1350,292,54,71,17
264207,1468,329,54,74,20
255501,1448,307,54,68,14
243213,913,302,54,64,10
237325,1518,316,54,65,11
260108,1408,298,54,62,8
227084,1560,327,54,61,7
254475,1371,303,54,70,16
248331,1504,321,54,61,7
260106,851,297,54,67,13
253962,1305,280,54,63,9
247304,1372,297,54,66,12
242952,1287,284,54,65,11
260103,1381,294,54,68,14
253447,1431,308,54,68,14
256774,1492,327,54,71,17
264454,1422,298,54,66,12
248067,1386,297,54,68,14
257953,1488,320,54,69,15
263832,1310,283,54,68,14
263844,1268,274,54,74,20
253054,1465,309,54,72,18
231547,1353,294,54,61,7
262523,1288,282,54,67,13
261242,1425,307,54,63,9
252538,824,293,54,67,13
263802,1347,292,54,70,16
262521,1257,282,54,69,15
236919,816,298,54,67,13
248182,782,296,54,63,9
261028,1328,286,54,60,6
261236,1471,325,54,64,10
260980,1358,297,54,57,3
263796,1247,275,54,69,15
248177,1434,310,54,54,0
253038,1322,282,54,72,18
263490,1374,295,54,57,3
264256,1295,278,54,72,18
262720,1484,319,54,65,11
261951,1330,278,54,54,0
258879,866,291,54,68,14
261500,1474,313,54,61,7
263030,1407,299,54,67,13
264575,1316,283,54,72,18
264362,1324,290,54,62,8
228992,1524,320,54,55,1
263077,1274,284,54,70,16
251815,922,304,54,68,14
256935,1310,286,54,68,14
263080,1345,306,54,67,13
263849,1318,291,54,72,18
242601,1320,286,54,65,11
256681,1421,308,54,70,16
263338,1325,290,54,71,17
250792,1335,292,54,62,8
255659,1248,269,54,64,10
259973,815,310,54,74,20
257965,1298,276,54,68,14
261506,1316,276,54,66,12
264067,1541,327,54,64,10
259713,1379,304,54,74,20
241542,1089,308,54,56,2
259465,1413,307,54,68,14
260269,1261,270,54,67,13
261668,1319,287,53,61,8
256798,1223,261,53,67,14
259358,1329,279,53,70,17
263711,1528,311,53,69,16
251423,853,293,53,68,15
254239,1354,294,53,66,13
260127,1368,293,53,74,21
257568,995,330,53,71,18
264225,1251,273,53,69,16
262180,1414,299,53,63,10
263972,1515,333,53,66,13
262962,1289,284,53,67,14
261414,1364,301,53,64,11
224555,972,296,53,56,3
245036,1298,280,53,63,10
256556,1472,320,53,78,25
257836,1311,279,53,69,16
259629,1311,283,53,70,17
263982,1445,307,53,66,13
256046,1418,310,53,71,18
256815,1322,294,53,67,14
263986,874,283,53,59,6
257469,849,292,53,68,15
263482,1277,281,53,70,17
247579,1238,263,53,60,7
258800,1323,284,53,56,3
253670,1296,280,53,62,9
263655,1219,272,53,73,20
262377,1256,270,53,60,7
263657,1489,322,53,61,8
263915,1319,280,53,68,15
222187,1510,328,53,53,0
262636,1278,284,53,63,10
263660,971,294,53,60,7
257260,1388,306,53,69,16
261100,1508,321,53,67,14
248815,1258,285,53,65,12
261871,1443,314,53,58,5
259568,1460,311,53,65,12
264676,977,317,53,67,14
248305,1421,307,53,63,10
222195,1301,284,53,53,0
261107,1292,287,53,72,19
263412,1246,271,53,63,10
262133,1462,326,53,71,18
260854,1458,315,53,67,14
248567,1356,288,53,73,20
259063,1498,319,53,70,17
260343,1367,302,53,67,14
240632,1403,303,53,62,9
263161,1453,306,53,69,16
261881,1378,297,53,67,14
252644,1415,297,53,63,10
251875,1256,278,53,66,13
222203,1310,278,53,53,0
248276,1366,291,53,56,3
261056,1367,289,53,71,18
241346,1220,264,53,53,0
264131,1457,312,53,70,17
263109,1418,304,53,61,8
264133,936,281,53,65,12
261062,1178,253,53,72,19
261063,1296,270,53,72,19
263368,860,295,53,62,9
252872,862,293,53,63,10
259274,1274,278,53,72,19
258003,1411,293,53,70,17
262099,1340,292,53,70,17
258005,1333,291,53,70,17
263650,1463,309,53,69,16
241622,1361,294,53,62,9
253398,821,294,53,70,17
259030,1461,310,53,69,16
259544,1442,310,53,62,9
256217,1431,314,53,69,16
263642,1299,286,53,71,18
264413,868,296,53,63,10
244958,1480,318,53,65,12
260319,827,283,53,54,1
264672,1431,297,53,63,10
262369,1486,318,53,61,8
252385,1432,309,53,68,15
241402,1224,255,53,68,15
256382,1198,260,53,64,11
264499,1269,272,53,61,8
260421,1434,301,53,61,8
264273,1406,305,53,72,19
246096,1416,307,53,66,13
263248,1382,293,53,73,20
247631,1350,293,53,64,11
257102,1407,295,53,72,19
241998,1356,288,53,58,5
263758,1347,297,53,69,16
247628,1364,302,53,59,6
243020,821,288,53,59,6
256330,1459,335,53,63,10
251976,1515,327,53,68,15
240455,1239,273,53,68,15
253509,1391,299,53,60,7
248404,911,297,53,66,13
252995,893,295,53,75,22
261954,1271,277,53,62,9
230722,1301,281,53,61,8
263746,1381,298,53,61,8
262210,1201,258,53,75,22
259137,1378,295,53,62,9
263998,1349,288,53,67,14
255547,1410,303,53,61,8
262846,778,287,53,63,10
259383,835,294,53,69,16
262966,1501,313,53,64,11
263220,1320,285,53,70,17
244817,838,279,53,63,10
260951,1343,283,53,75,22
251262,1433,300,53,67,14
248679,1425,305,53,73,20
261244,1365,296,53,66,13
260732,1250,270,53,73,20
251514,1350,292,53,70,17
260472,892,299,53,63,10
257652,1234,262,53,67,14
262514,1326,285,53,76,23
264305,1237,268,53,72,19
248175,1490,320,53,69,16
239727,844,293,53,57,4
260717,1338,297,53,65,12
253035,1335,293,53,60,7
258409,888,302,53,65,12
264295,1455,324,53,73,20
262233,1521,320,53,56,3
248678,1379,308,53,69,16
262245,1472,309,53,74,21
259940,1355,290,53,64,11
254819,1386,288,53,78,25
263779,1222,264,53,68,15
256865,1353,298,53,69,16
256609,867,292,53,76,23
261215,1283,281,53,66,13
260703,1327,275,53,71,18
255071,1212,259,53,68,15
263517,1382,294,53,67,14
255836,1320,282,53,62,9
252699,814,292,53,65,12
261502,1464,314,53,69,16
223771,1322,280,53,53,0
242086,824,279,53,66,13
257688,1318,278,53,60,7
263322,1363,296,53,68,15
263834,1278,282,53,70,17
247962,1208,254,53,74,21
263835,1347,287,53,70,17
263325,1400,300,53,68,15
264093,1321,288,53,71,18
262047,1294,280,53,63,10
263329,1318,290,53,69,16
257186,1454,310,53,71,18
260260,1336,285,53,74,21
263845,1375,300,53,55,2
242853,868,299,53,68,15
261031,1432,306,53,74,21
262552,1380,285,53,68,15
264360,1417,303,53,68,15
263083,1253,269,53,68,15
262572,1327,289,53,67,14
252844,1256,271,53,68,15
233645,1395,301,53,60,7
264366,1319,286,53,68,15
245166,1283,283,53,58,5
255918,1287,289,53,62,9
258736,1352,292,53,67,14
263090,1290,286,53,76,23
259763,1335,290,53,69,16
263092,842,290,53,70,17
224692,1253,265,53,54,1
253080,1394,302,53,62,9
259991,1263,278,53,64,11
242108,1468,320,53,64,11
263962,1200,256,53,68,15
261115,1298,278,53,59,6
248318,1567,334,53,62,9
263295,1265,267,53,66,13
259201,1381,311,53,67,14
260737,1324,283,53,64,11
264071,1255,278,53,66,13
257671,1339,289,53,70,17
263304,1211,260,53,72,19
259464,1211,260,53,68,15
252809,1337,294,53,61,8
253065,871,298,53,63,10
264074,1494,317,53,64,11
263308,1313,279,53,72,19
264334,1217,263,53,71,18
253079,1295,283,53,70,17
264080,1433,304,53,65,12
255632,1274,281,53,56,3
260497,1489,321,53,62,9
258962,821,287,53,59,6
259730,1233,268,53,61,8
263827,857,296,53,69,16
240531,900,291,53,60,7
248723,1355,290,53,66,13
259475,1392,304,53,65,12
222612,934,297,53,58,5
257684,1313,285,53,63,10
258197,1430,304,53,64,11
264599,1432,309,53,71,18
258228,1468,316,53,67,14
264333,1339,290,53,69,16
264704,1320,287,53,70,17
264203,1329,286,53,71,18
248857,1382,289,53,65,12
241920,1241,270,53,69,16
262914,904,300,53,70,17
262915,1383,302,53,71,18
263683,1403,302,53,56,3
263431,1286,282,53,65,12
228103,1044,313,53,63,10
240393,1439,327,53,61,8
261129,1347,297,53,60,7
261386,1461,306,53,65,12
240391,1466,325,53,58,5
264204,1374,297,53,67,14
259596,906,297,53,68,15
263182,1416,304,53,70,17
264206,1515,331,53,64,11
257040,1237,270,53,70,17
256531,1413,302,53,67,14
261910,1354,301,53,71,18
253708,1389,305,53,67,14
264114,1251,262,52,58,6
251562,1201,252,52,67,15
260010,1319,277,52,66,14
255660,1236,266,52,67,15
258732,907,297,52,68,16
263598,827,281,52,60,8
262326,1465,314,52,63,11
261042,821,282,52,52,0
248247,1373,296,52,57,5
263091,808,287,52,69,17
256435,1420,305,52,70,18
261287,1319,285,52,66,14
260521,1265,271,52,69,17
256304,1305,288,52,59,7
260007,1286,271,52,63,11
254119,1236,265,52,70,18
255141,872,287,52,66,14
236452,1335,289,52,58,6
263331,843,283,52,68,16
262050,1282,286,52,62,10
264354,1483,315,52,68,16
260001,1225,270,52,70,18
260538,882,293,52,64,12
261536,1474,322,52,66,14
263840,1273,267,52,68,16
263328,1463,313,52,67,15
259258,1441,310,52,65,13
264646,850,289,52,58,6
263867,900,296,52,69,17
263884,1292,277,52,70,18
242696,1444,309,52,61,9
261387,1277,270,52,67,15
255500,1440,309,52,61,9
261645,866,294,52,67,15
262358,832,283,52,66,14
257748,1452,307,52,66,14
264656,1333,297,52,62,10
257999,804,277,52,57,5
256463,871,298,52,63,11
245455,1397,284,52,62,10
255948,1378,294,52,64,12
260553,1180,255,52,67,15
245435,1104,289,52,57,5
262088,1306,285,52,69,17
257223,1217,263,52,66,14
257949,1189,248,52,68,16
252612,1283,273,52,61,9
251586,1277,286,52,62,10
231618,922,281,52,62,10
149697,1172,245,52,52,0
248256,846,285,52,69,17
233407,909,281,52,57,5
260797,1183,254,52,59,7
248253,1300,280,52,67,15
255903,1344,292,52,73,21
263314,841,283,52,61,9
247707,1359,295,52,66,14
250777,801,285,52,66,14
263977,1439,291,52,66,14
246313,1328,278,52,67,15
256811,1318,287,52,70,18
261419,1212,263,52,65,13
263212,1286,279,52,70,18
263214,846,286,52,68,16
253744,1379,295,52,53,1
259120,1433,301,52,67,15
263985,1416,302,52,75,23
261425,1468,308,52,55,3
259378,1360,292,52,65,13
254515,1318,281,52,64,12
245558,848,275,52,52,0
250935,1489,315,52,66,14
261432,1274,257,52,68,16
262713,1377,293,52,67,15
263994,1464,317,52,67,15
252730,871,282,52,62,10
253499,1387,305,52,67,15
260411,1301,277,52,71,19
257085,855,303,52,66,14
263745,1479,307,52,67,15
259648,1404,296,52,64,12
263744,1385,296,52,62,10
246079,1287,274,52,64,12
256552,1250,255,52,65,13
264232,1258,272,52,63,11
263975,1401,302,52,75,23
264468,1453,313,52,71,19
243097,1464,320,52,58,6
248214,805,279,52,66,14
259733,845,286,52,57,5
237205,885,280,52,64,12
259476,1409,298,52,67,15
264084,1388,295,52,66,14
259987,868,301,52,69,17
264455,1322,295,52,59,7
261391,1415,293,52,62,10
263185,1279,277,52,63,11
263187,1203,262,52,64,12
257812,1389,298,52,64,12
258086,1335,281,52,67,15
258837,1483,318,52,68,16
256280,1433,308,52,62,10
255769,1292,277,52,67,15
262170,1304,275,52,71,19
261914,826,290,52,64,12
259357,1311,283,52,69,17
260381,1325,289,52,67,15
246815,1219,259,52,65,13
263712,836,286,52,62,10
254240,1283,272,52,65,13
260387,1329,300,52,75,23
261895,833,287,52,59,7
248324,904,297,52,52,0
259133,1327,278,52,67,15
248683,856,293,52,68,16
260462,1361,289,52,69,17
256879,779,291,52,62,10
263795,1228,258,52,52,0
252788,889,294,52,64,12
260724,1162,251,52,72,20
256377,1247,273,52,65,13
256379,1461,306,52,63,11
251516,1458,323,52,64,12
227969,969,285,52,54,2
243073,907,290,52,52,0
257921,933,301,52,68,16
256387,843,283,52,62,10
262533,1474,315,52,75,23
259718,803,271,52,66,14
260998,1280,277,52,60,8
262535,1307,291,52,60,8
247176,858,292,52,61,9
261119,1404,304,52,72,20
257023,1443,302,52,73,21
263167,1233,265,52,70,18
263930,1362,299,52,70,18
252665,1314,282,52,66,14
261109,1319,297,52,70,18
248308,1422,304,52,61,9
261875,1373,290,52,65,13
261872,1342,283,52,65,13
261615,1280,280,52,52,0
257262,1313,286,52,66,14
261357,1224,269,52,70,18
256109,1451,310,52,65,13
264043,1293,287,52,66,14
252419,1414,308,52,65,13
245610,854,290,52,61,9
253506,1477,302,52,61,9
262723,943,286,52,62,10
256323,878,290,52,71,19
256836,1339,282,52,61,9
251973,1488,313,52,61,9
261190,1363,289,52,61,9
264519,1268,272,52,70,18
262216,1263,266,52,70,18
260424,1443,302,52,72,20
260681,1364,285,52,64,12
260426,1387,296,52,72,20
261194,1283,274,52,66,14
244555,1273,279,52,65,13
264271,1338,286,52,66,14
264528,1357,290,52,62,10
264530,1266,282,52,59,7
247634,1223,266,52,57,5
259156,1330,296,52,68,16
254549,1232,269,52,65,13
259669,1354,290,52,73,21
263510,841,273,52,67,15
264282,828,282,52,67,15
261725,1408,298,52,65,13
259426,1407,298,52,66,14
259428,1420,308,52,68,16
258662,1384,301,52,70,18
264296,1432,307,52,67,15
246120,1468,315,52,67,15
264041,1397,306,52,70,18
258541,1320,281,52,69,17
262378,1226,268,52,65,13
263400,1283,272,52,63,11
255369,1323,277,52,69,17
259329,854,286,52,63,11
264192,1459,313,52,65,13
256999,1271,273,52,70,18
259985,1363,291,52,65,13
259729,860,286,52,61,9
259472,1434,309,52,64,12
252816,1256,274,52,65,13
259471,1342,289,52,66,14
262542,1291,279,52,71,19
259469,838,292,52,70,18
254092,1237,263,52,65,13
260414,1440,322,52,75,23
255368,872,301,52,64,12
257250,1422,305,52,65,13
259291,1359,282,52,71,19
258277,1296,280,52,70,18
264675,1287,278,52,67,15
262627,1296,276,52,67,15
263399,861,286,52,61,9
256993,1472,309,52,61,9
256992,1303,278,52,60,8
258527,1304,295,52,61,9
247775,1299,279,52,52,0
264677,1380,292,52,62,10
260838,1326,285,51,68,17
263899,1354,292,51,69,18
241627,1187,255,51,60,9
259547,1203,259,51,67,16
253154,1378,310,51,63,12
262373,806,285,51,63,12
241638,1305,281,51,65,14
259311,1299,274,51,66,15
262631,1411,305,51,65,14
248039,1399,297,51,67,16
233449,1367,292,51,51,0
258537,1414,303,51,63,12
248273,1305,287,51,51,0
253681,1370,296,51,68,17
252658,852,279,51,66,15
262645,1382,292,51,65,14
259282,1231,250,51,69,18
247498,1401,287,51,57,6
262094,1336,281,51,68,17
262862,805,276,51,70,19
245417,1224,260,51,58,7
263850,1203,268,51,64,13
251563,838,272,51,62,11
248237,1374,300,51,61,10
245423,1397,297,51,58,7
262063,1289,272,51,65,14
261296,1352,292,51,73,22
262323,1482,303,51,65,14
262325,997,310,51,66,15
262588,1156,252,51,67,16
241341,1556,333,51,56,5
259006,819,268,51,57,6
263363,1268,267,51,64,13
262852,1204,263,51,66,15
263877,767,280,51,66,15
263373,805,280,51,64,13
256461,1258,273,51,65,14
263350,1436,313,51,67,16
251564,1278,269,51,66,15
248222,1414,307,51,51,0
261524,1434,299,51,62,11
264065,1380,296,51,68,17
261763,1161,247,51,61,10
264068,827,275,51,68,17
256388,1368,293,51,64,13
245130,771,279,51,64,13
262540,1227,258,51,67,16
263055,1322,275,51,51,0
259727,1304,282,51,63,12
263824,1430,315,51,68,17
243089,1418,310,51,66,15
263058,1420,303,51,66,15
262039,1275,291,51,65,14
264057,810,277,51,74,23
264602,1450,310,51,67,16
260250,1196,256,51,66,15
263838,824,276,51,68,17
257187,1232,268,51,70,19
263848,1280,277,51,57,6
262913,1503,324,51,68,17
253697,1500,321,51,57,6
230146,1351,288,51,51,0
253186,768,274,51,61,10
256006,869,291,51,61,10
245512,1325,275,51,62,11
261246,1068,227,51,60,9
260982,813,286,51,77,26
259347,853,287,51,65,14
263766,1270,274,51,71,20
247873,1404,301,51,65,14
255554,1346,295,51,66,15
263491,1352,291,51,69,18
259651,1156,252,51,59,8
264517,1415,302,51,73,22
264518,1419,295,51,70,19
247624,1331,288,51,62,11
241482,1418,311,51,53,2
260938,1217,253,51,69,18
260174,1359,294,51,64,13
228948,1044,285,51,51,0
248150,865,278,51,54,3
261748,1261,269,51,59,8
264023,1371,291,51,60,9
259160,1293,286,51,66,15
260699,1447,310,51,65,14
256605,1290,290,51,64,13
261472,820,279,51,68,17
261984,852,275,51,58,7
254307,1343,286,51,74,23
252516,1383,285,51,58,7
258661,1379,291,51,73,22
257897,1219,259,51,64,13
260977,1403,292,51,68,17
261901,1178,254,51,59,8
263699,878,288,51,68,17
263722,1471,317,51,67,16
261930,1197,251,51,63,12
261916,1258,270,51,59,8
261917,1386,294,51,55,4
261921,1274,271,51,59,8
262178,1345,297,51,66,15
260132,1437,315,51,69,18
256807,1456,319,51,69,18
264469,1331,280,51,62,11
259628,1308,286,51,69,18
253467,1325,289,51,59,8
264493,1318,287,51,65,14
261677,1279,268,51,75,24
263215,1316,294,51,62,11
258351,859,275,51,68,17
253745,863,274,51,59,8
256305,1325,293,51,61,10
253746,1448,315,51,61,10
254492,1188,252,51,71,20
264255,1251,275,51,68,17
244507,1442,311,51,65,14
263224,1293,281,51,63,12
264475,838,287,51,64,13
259134,1409,289,51,70,19
253502,1384,301,51,65,14
247357,1269,270,51,71,20
264509,1221,269,51,74,23
262715,1242,264,51,66,15
261946,1403,305,51,64,13
263739,1204,248,51,66,15
261431,1300,283,51,65,14
263990,1312,294,51,72,21
229429,902,293,51,60,9
262965,784,276,51,58,7
240917,1470,315,51,60,9
259349,1439,300,51,65,14
256791,1354,290,51,63,12
261952,1374,290,50,56,6
262452,1384,303,50,68,18
255551,1105,236,50,58,8
263999,1336,278,50,70,20
255549,1172,252,50,61,11
262972,1233,261,50,62,12
259129,1164,239,50,74,24
245046,1220,250,50,58,8
264500,1360,291,50,63,13
259857,1272,290,50,67,17
260146,825,282,50,59,9
261670,1216,266,50,66,16
261669,1212,258,50,58,8
261924,1261,271,50,56,6
258586,827,273,50,68,18
252181,1248,273,50,58,8
261905,1288,276,50,57,7
256515,1255,268,50,69,19
253698,1295,269,50,61,11
256324,1297,291,50,64,14
243202,792,267,50,66,16
258372,1413,300,50,66,16
259742,1216,265,50,56,6
260767,1249,280,50,70,20
243107,1268,275,50,55,5
261292,809,284,50,65,15
257709,1238,261,50,57,7
261301,1239,268,50,60,10
264119,1405,304,50,66,16
256439,1392,290,50,65,15
260535,1289,278,50,62,12
260536,1226,256,50,63,13
241594,1192,251,50,58,8
264645,797,273,50,67,17
256458,1204,258,50,70,20
258762,860,276,50,68,18
261075,1427,307,50,63,13
257493,1181,256,50,55,5
256472,1353,289,50,70,20
264259,823,282,50,67,17
259738,1372,292,50,55,5
257685,1301,277,50,59,9
262020,1372,289,50,64,14
260742,1318,285,50,68,18
263560,1407,296,50,61,11
262541,1406,291,50,65,15
248206,1288,268,50,59,9
257936,1388,305,50,50,0
252561,1133,238,50,69,19
264341,1277,279,50,58,8
264087,1459,307,50,72,22
253657,1308,282,50,60,10
263387,1411,300,50,60,10
262623,1494,319,50,70,20
263394,1412,300,50,57,7
256994,1364,284,50,62,12
256997,1177,257,50,59,9
262886,834,281,50,65,15
259303,1360,289,50,60,10
259560,1249,268,50,61,11
262123,1238,268,50,59,9
253677,1316,286,50,63,13
264686,1399,294,50,70,20
253423,796,271,50,55,5
262127,1294,277,50,58,8
264177,1421,301,50,69,19
262651,1268,269,50,64,14
258556,860,270,50,62,12
263933,1314,281,50,59,9
261886,1178,253,50,53,3
264070,1177,253,50,67,17
264329,1431,302,50,69,19
261762,1399,293,50,61,11
258659,886,285,50,56,6
261959,1192,252,50,56,6
260176,1166,246,50,60,10
247633,1280,270,50,55,5
256599,810,270,50,68,18
261979,819,279,50,55,5
261980,815,271,50,56,6
263261,1288,278,50,61,11
261981,1200,256,50,62,12
264030,1363,294,50,72,22
232286,1419,296,50,53,3
263039,1348,283,50,60,10
254562,810,275,50,70,20
262558,1394,290,50,66,16
261983,797,275,50,53,3
264300,1439,301,50,69,19
264055,1192,251,50,60,10
264061,1424,303,50,62,12
264302,836,278,50,69,19
264569,1415,294,50,65,15
264568,1234,267,50,66,16
260983,1391,287,50,73,23
264060,805,271,50,62,12
261750,1265,272,50,58,8
259702,928,284,50,70,20
261746,837,289,50,68,18
255601,844,280,50,60,10
261956,1372,286,49,54,5
245542,828,260,49,64,15
261945,1165,244,49,53,4
248376,1292,276,49,61,12
260147,1414,300,49,58,9
261938,1166,244,49,65,16
261426,1403,297,49,58,9
260912,1389,291,49,74,25
261423,845,288,49,66,17
253737,802,260,49,65,16
253403,1330,289,49,67,18
253477,1313,275,49,61,12
252196,1394,304,49,56,7
263202,1406,298,49,62,13
253466,1245,263,49,52,3
254232,1316,274,49,61,12
157190,1419,276,49,49,0
261890,1385,294,49,54,5
261888,1242,263,49,56,7
248286,1268,272,49,57,8
261961,882,274,49,56,7
252756,1389,297,49,61,12
261986,1370,286,49,56,7
264390,1382,300,49,66,17
259488,853,264,49,68,19
260004,1246,271,49,64,15
260522,813,262,49,69,20
256427,1264,270,49,65,16
259761,1335,279,49,59,10
259764,1342,290,49,56,7
261302,1134,241,49,58,9
247224,884,281,49,55,6
261052,1377,291,49,58,9
259005,1347,279,49,56,7
248268,1354,280,49,62,13
256414,1257,271,49,59,10
261988,1150,247,49,64,15
257494,1408,291,49,51,2
258558,1294,268,49,62,13
247038,1349,283,49,66,17
264190,829,277,49,57,8
262125,1368,290,49,63,14
259561,1398,301,49,63,14
256996,1259,266,49,54,5
262625,1372,288,49,60,11
256991,1241,278,49,61,12
256415,1289,269,49,62,13
264142,1368,292,49,62,13
257693,1149,247,49,55,6
264075,1309,280,49,58,9
256413,849,267,49,60,11
255618,1239,265,49,49,0
255617,1252,264,49,55,6
261759,1253,277,49,67,18
261751,1335,281,49,64,15
263543,1174,252,49,65,16
262004,1165,250,49,73,24
250989,1157,247,49,55,6
263271,1227,265,49,72,23
264072,1314,272,49,67,18
255856,1274,272,49,60,11
243084,1450,312,49,54,5
259731,802,267,49,52,3
264340,1194,255,49,60,11
258964,1164,241,49,55,6
259220,1251,263,49,62,13
257689,1162,243,49,55,6
262041,1128,242,49,67,18
259218,1241,264,49,58,9
257690,1370,296,49,61,12
256923,807,260,49,63,14
261424,1287,275,48,52,4
259649,1321,276,48,65,17
255553,1248,271,48,61,13
261939,1341,280,48,52,4
255251,1229,273,48,56,8
261935,1375,291,48,58,10
261666,1171,247,48,57,9
253966,1416,302,48,62,14
261958,836,269,48,54,6
261957,1288,272,48,53,5
259175,1170,252,48,59,11
264016,1216,251,48,58,10
262034,1187,258,48,60,12
261548,1212,250,48,58,10
252332,1360,289,48,56,8
263340,850,273,48,65,17
258987,1350,284,48,53,5
259745,1190,253,48,56,8
243101,1345,289,48,54,6
257691,1346,281,48,54,6
257934,1338,280,48,53,5
261976,1381,285,48,55,7
257930,1217,241,48,53,5
260474,1376,289,48,57,9
255336,811,270,48,73,25
262759,1160,246,48,62,14
250978,964,285,48,52,4
261985,1166,247,48,55,7
261977,1198,250,48,58,10
261932,1179,245,48,53,5